"state_name","county_fips","county_name","votes_gop","votes_dem","total_votes","diff","per_gop","per_dem","per_point_diff"
"Alabama",1001,"Autauga County",19838,7503,27770,12335,0.714368023046453,0.270183651422398,0.444184371624055
"Alabama",1003,"Baldwin County",83544,24578,109679,58966,0.761713728243328,0.22409029987509,0.537623428368238
"Alabama",1005,"Barbour County",5622,4816,10518,806,0.534512264689104,0.457881726563986,0.0766305381251188
"Alabama",1007,"Bibb County",7525,1986,9595,5539,0.784262636789995,0.206982803543512,0.577279833246482
"Alabama",1009,"Blount County",24711,2640,27588,22071,0.895715528490648,0.0956937799043062,0.800021748586342
"Alabama",1011,"Bullock County",1146,3446,4613,-2300,0.248428354649902,0.747019293301539,-0.498590938651637
"Alabama",1013,"Butler County",5458,3965,9488,1493,0.575252951096121,0.41789629005059,0.157356661045531
"Alabama",1015,"Calhoun County",35101,15216,50983,19885,0.688484396759704,0.298452425318243,0.390031971441461
"Alabama",1017,"Chambers County",8753,6365,15284,2388,0.572690395184507,0.416448573671814,0.156241821512693
"Alabama",1019,"Cherokee County",10583,1624,12301,8959,0.860336558003414,0.132021786846598,0.728314771156817
"Alabama",1021,"Chilton County",16085,3073,19310,13012,0.832988089073019,0.159140341791818,0.673847747281201
"Alabama",1023,"Choctaw County",4296,3127,7464,1169,0.57556270096463,0.418944265809218,0.156618435155413
"Alabama",1025,"Clarke County",7324,5755,13135,1569,0.557594213932242,0.438142367719833,0.11945184621241
"Alabama",1027,"Clay County",5601,1267,6930,4334,0.808225108225108,0.182828282828283,0.625396825396825
"Alabama",1029,"Cleburne County",6484,675,7227,5809,0.897191088971911,0.0933997509339975,0.803791338037913
"Alabama",1031,"Coffee County",16899,5076,22275,11823,0.758653198653199,0.227878787878788,0.530774410774411
"Alabama",1033,"Colbert County",19203,8343,27886,10860,0.688625116545937,0.299182385426379,0.389442731119558
"Alabama",1035,"Conecuh County",3442,2966,6441,476,0.534389070020183,0.460487501940692,0.0739015680794908
"Alabama",1037,"Coosa County",3631,1796,5479,1835,0.662712173754335,0.327797043256069,0.334915130498266
"Alabama",1039,"Covington County",14586,2721,17430,11865,0.836833046471601,0.156110154905336,0.680722891566265
"Alabama",1041,"Crenshaw County",4864,1700,6617,3164,0.735076318573372,0.256914009369805,0.478162309203567
"Alabama",1043,"Cullman County",36880,4478,41851,32402,0.881221476189338,0.106998638025376,0.774222838163963
"Alabama",1045,"Dale County",14303,5170,19738,9133,0.724642820954504,0.261931300030398,0.462711520924106
"Alabama",1047,"Dallas County",5524,12230,17864,-6706,0.30922525750112,0.6846171070309,-0.375391849529781
"Alabama",1049,"DeKalb County",24767,4281,29356,20486,0.843677612753781,0.145830494617795,0.697847118135986
"Alabama",1051,"Elmore County",30164,10367,41030,19797,0.735169388252498,0.252668778942237,0.482500609310261
"Alabama",1053,"Escambia County",10869,4918,15910,5951,0.683155248271527,0.309113764927718,0.374041483343809
"Alabama",1055,"Etowah County",35528,11567,47728,23961,0.744384847468991,0.242352497485753,0.502032349983238
"Alabama",1057,"Fayette County",7300,1395,8766,5905,0.832762947752681,0.159137577002053,0.673625370750627
"Alabama",1059,"Franklin County",10376,2086,12578,8290,0.824932421688663,0.165845126411194,0.659087295277469
"Alabama",1061,"Geneva County",10848,1595,12545,9253,0.864726982861698,0.127142287764049,0.737584695097648
"Alabama",1063,"Greene County",875,3884,4775,-3009,0.183246073298429,0.813403141361257,-0.630157068062827
"Alabama",1065,"Hale County",3190,4687,7922,-1497,0.402676091895986,0.591643524362535,-0.188967432466549
"Alabama",1067,"Henry County",6607,2606,9298,4001,0.710582921058292,0.280275328027533,0.430307593030759
"Alabama",1069,"Houston County",32618,12917,46173,19701,0.706430164814935,0.279752236155329,0.426677928659606
"Alabama",1071,"Jackson County",19670,3717,23636,15953,0.832205110847859,0.157260111694026,0.674944999153833
"Alabama",1073,"Jefferson County",138843,181688,325848,-42845,0.426097444207115,0.557585131717856,-0.131487687510741
"Alabama",1075,"Lamar County",6174,978,7193,5196,0.858334491867093,0.135965522035312,0.722368969831781
"Alabama",1077,"Lauderdale County",31721,11915,44339,19806,0.71541983355511,0.268725050181556,0.446694783373554
"Alabama",1079,"Lawrence County",12322,3562,16031,8760,0.768635768199114,0.222194498159815,0.546441270039299
"Alabama",1081,"Lee County",42221,27860,71449,14361,0.590924995451301,0.38992848045459,0.200996514996711
"Alabama",1083,"Limestone County",34640,13672,49235,20968,0.703564537422565,0.277688636132832,0.425875901289733
"Alabama",1085,"Lowndes County",1836,4972,6835,-3136,0.26861741038771,0.727432333577176,-0.458814923189466
"Alabama",1087,"Macon County",1541,7108,8723,-5567,0.176659406167603,0.814857273873667,-0.638197867706064
"Alabama",1089,"Madison County",102780,87286,194767,15494,0.527707465843803,0.44815600178675,0.0795514640570528
"Alabama",1091,"Marengo County",5343,5488,10900,-145,0.490183486238532,0.50348623853211,-0.013302752293578
"Alabama",1093,"Marion County",12205,1463,13807,10742,0.88397189831245,0.105960744549866,0.778011153762584
"Alabama",1095,"Marshall County",33191,5943,39655,27248,0.836994073887278,0.149867608120035,0.687126465767242
"Alabama",1097,"Mobile County",101243,79474,183164,21769,0.552745080911096,0.433895306938045,0.118849773973052
"Alabama",1099,"Monroe County",6147,4455,10668,1692,0.576209223847019,0.417604049493813,0.158605174353206
"Alabama",1101,"Montgomery County",33311,64529,99139,-31218,0.336002985706937,0.650894199053854,-0.314891213346917
"Alabama",1103,"Morgan County",39664,13234,53722,26430,0.738319496668032,0.24634228062991,0.491977216038122
"Alabama",1105,"Perry County",1339,3860,5230,-2521,0.256022944550669,0.738049713193117,-0.482026768642447
"Alabama",1107,"Pickens County",5594,4022,9668,1572,0.578609846917666,0.416011584609019,0.162598262308647
"Alabama",1109,"Pike County",8042,5636,13841,2406,0.581027382414565,0.407196011848855,0.173831370565711
"Alabama",1111,"Randolph County",8559,2203,10837,6356,0.789794223493587,0.203285041985789,0.586509181507797
"Alabama",1113,"Russell County",9864,11228,21329,-1364,0.462468939003235,0.526419428946505,-0.0639504899432697
"Alabama",1115,"St. Clair County",36166,7744,44441,28422,0.813798069350375,0.17425350464661,0.639544564703765
"Alabama",1117,"Shelby County",79700,33268,114950,46432,0.693344932579382,0.289412788168769,0.403932144410613
"Alabama",1119,"Sumter County",1598,4648,6291,-3050,0.254013670322683,0.738833253854713,-0.48481958353203
"Alabama",1121,"Talladega County",22235,13138,35663,9097,0.623475310545944,0.368393012365757,0.255082298180187
"Alabama",1123,"Tallapoosa County",14963,5859,20991,9104,0.71282930779858,0.279119622695441,0.433709685103139
"Alabama",1125,"Tuscaloosa County",51117,37765,90172,13352,0.566883289712993,0.418810717295835,0.148072572417158
"Alabama",1127,"Walker County",26002,4834,31170,21168,0.834199550850176,0.155085017645172,0.679114533205005
"Alabama",1129,"Washington County",6564,2258,8876,4306,0.739522307345651,0.254393871113114,0.485128436232537
"Alabama",1131,"Wilcox County",1833,4048,5903,-2215,0.31052007453837,0.685753006945621,-0.375232932407251
"Alabama",1133,"Winston County",10195,974,11284,9221,0.903491669620702,0.0863169088975541,0.817174760723148
"Alaska",2901,"District 1",3511,3477,7360,34,0.477038043478261,0.47241847826087,0.00461956521739126
"Alaska",2902,"District 2",3674,2104,6161,1570,0.596331764323973,0.341503002759292,0.254828761564681
"Alaska",2903,"District 3",6076,1903,8385,4173,0.724627310673822,0.226952892069171,0.497674418604651
"Alaska",2904,"District 4",4690,5345,10587,-655,0.442996127325966,0.504864456408803,-0.0618683290828375
"Alaska",2905,"District 5",4077,4204,8706,-127,0.468297725706409,0.482885366413967,-0.014587640707558
"Alaska",2906,"District 6",5770,3272,9518,2498,0.606219794074385,0.343769699516705,0.26245009455768
"Alaska",2907,"District 7",7027,2215,9664,4812,0.727131622516556,0.229201158940397,0.497930463576159
"Alaska",2908,"District 8",7618,1953,9957,5665,0.765089886512002,0.196143416691775,0.568946469820227
"Alaska",2909,"District 9",7787,2769,11047,5018,0.704897257173893,0.25065628677469,0.454240970399203
"Alaska",2910,"District 10",8081,2727,11256,5354,0.717928216062544,0.24227078891258,0.475657427149965
"Alaska",2911,"District 11",7096,3130,10686,3966,0.664046415871233,0.29290660677522,0.371139809096014
"Alaska",2912,"District 12",7893,2957,11280,4936,0.699734042553191,0.262145390070922,0.43758865248227
"Alaska",2913,"District 13",4652,2666,7765,1986,0.599098518995493,0.343335479716677,0.255763039278815
"Alaska",2914,"District 14",6714,4261,11534,2453,0.582105080631177,0.369429512744928,0.212675567886249
"Alaska",2915,"District 15",2671,2622,5593,49,0.477561237260862,0.468800286071876,0.00876095118898623
"Alaska",2916,"District 16",3516,4274,8170,-758,0.430354957160343,0.52313341493268,-0.0927784577723378
"Alaska",2917,"District 17",2810,4136,7271,-1326,0.386466785861642,0.568835098335855,-0.182368312474213
"Alaska",2918,"District 18",2760,4681,7759,-1921,0.355715942776131,0.603299394251837,-0.247583451475706
"Alaska",2919,"District 19",1975,3118,5338,-1143,0.369988759835144,0.584113900337205,-0.214125140502061
"Alaska",2920,"District 20",2383,4881,7544,-2498,0.315880169671262,0.647004241781548,-0.331124072110286
"Alaska",2921,"District 21",3690,5414,9482,-1724,0.389158405399705,0.570976587217886,-0.181818181818182
"Alaska",2922,"District 22",4684,4553,9597,131,0.488069188288007,0.474419089298739,0.0136500989892674
"Alaska",2923,"District 23",3655,3810,7796,-155,0.468830169317599,0.488712160082093,-0.0198819907644947
"Alaska",2924,"District 24",5378,4736,10484,642,0.512972148035101,0.451735978634109,0.061236169400992
"Alaska",2925,"District 25",4407,4600,9369,-193,0.470381043868076,0.490980894439108,-0.0205998505710321
"Alaska",2926,"District 26",5243,4558,20292,685,0.258377685787502,0.224620540114331,0.0337571456731717
"Alaska",2927,"District 27",4324,4844,19037,-520,0.227136628670484,0.254451856910227,-0.0273152282397436
"Alaska",2928,"District 28",6162,6264,25580,-102,0.240891321344801,0.24487881157154,-0.00398749022673964
"Alaska",2929,"District 29",7464,2985,10784,4479,0.69213649851632,0.276798961424332,0.415337537091988
"Alaska",2930,"District 30",7180,2638,10226,4542,0.702131820848817,0.257969880696264,0.444161940152552
"Alaska",2931,"District 31",6971,5037,12481,1934,0.558528964025318,0.403573431616056,0.154955532409262
"Alaska",2932,"District 32",4440,3506,8361,934,0.531036957301758,0.419327831599091,0.111709125702667
"Alaska",2933,"District 33",3059,7535,11016,-4476,0.277687000726216,0.684005083514887,-0.406318082788671
"Alaska",2934,"District 34",4543,5763,10794,-1220,0.420881971465629,0.53390772651473,-0.113025755049101
"Alaska",2935,"District 35",4769,5011,10149,-242,0.469898512168687,0.49374322593359,-0.0238447137649029
"Alaska",2936,"District 36",5114,3796,9292,1318,0.550365906155833,0.408523461041756,0.141842445114077
"Alaska",2937,"District 37",2358,2560,5168,-202,0.456269349845201,0.495356037151703,-0.0390866873065016
"Alaska",2938,"District 38",1737,3202,5299,-1465,0.327797697678807,0.60426495565201,-0.276467257973202
"Alaska",2939,"District 39",1939,3580,5930,-1641,0.326981450252951,0.603709949409781,-0.27672849915683
"Alaska",2940,"District 40",1994,2318,4628,-324,0.43085566119274,0.500864304235091,-0.0700086430423509
"Arizona",4001,"Apache County",11442,23293,35183,-11851,0.325213881704232,0.662052695904272,-0.33683881420004
"Arizona",4003,"Cochise County",35557,23732,60473,11825,0.587981413192665,0.392439601144312,0.195541812048352
"Arizona",4005,"Coconino County",27052,44698,73346,-17646,0.368827202574101,0.609412919586617,-0.240585717012516
"Arizona",4007,"Gila County",18377,8943,27678,9434,0.66395693330443,0.323108606113158,0.340848327191271
"Arizona",4009,"Graham County",10749,4034,14996,6715,0.716791144305148,0.269005068018138,0.44778607628701
"Arizona",4011,"Greenlee County",2433,1182,3688,1251,0.65970715835141,0.320498915401302,0.339208242950108
"Arizona",4012,"La Paz County",5129,2236,7460,2893,0.687533512064343,0.299731903485255,0.387801608579089
"Arizona",4013,"Maricopa County",995665,1040774,2069475,-45109,0.481119607629954,0.502916923374286,-0.0217973157443312
"Arizona",4015,"Mohave County",78535,24831,104705,53704,0.750059691514254,0.237151998471897,0.512907693042357
"Arizona",4017,"Navajo County",27657,23383,51783,4274,0.53409420079949,0.45155746094278,0.0825367398567098
"Arizona",4019,"Pima County",207758,304981,520735,-97223,0.398970685665454,0.585674095269187,-0.186703409603733
"Arizona",4021,"Pinal County",107077,75106,185037,31971,0.57867885882283,0.405897198938591,0.172781659884239
"Arizona",4023,"Santa Cruz County",6194,13138,19561,-6944,0.316650477991923,0.671642554061653,-0.354992076069731
"Arizona",4025,"Yavapai County",91527,49602,143280,41925,0.638798157453936,0.346189279731993,0.292608877721943
"Arizona",4027,"Yuma County",36534,32210,69926,4324,0.52246660755656,0.460629808654864,0.0618367989016961
"Arkansas",5001,"Arkansas County",4304,1818,6292,2486,0.684043229497775,0.28893833439288,0.395104895104895
"Arkansas",5003,"Ashley County",5548,2125,7926,3423,0.699974766590966,0.26810497098158,0.431869795609387
"Arkansas",5005,"Baxter County",15836,4635,21007,11201,0.753843956776313,0.220640738801352,0.533203217974961
"Arkansas",5007,"Benton County",73965,42249,119912,31716,0.61682734004937,0.352333377810394,0.264493962238975
"Arkansas",5009,"Boone County",13652,3064,17114,10588,0.797709477620661,0.17903470842585,0.618674769194811
"Arkansas",5011,"Bradley County",2335,1214,3654,1121,0.639025725232622,0.33223864258347,0.306787082649152
"Arkansas",5013,"Calhoun County",1636,479,2182,1157,0.749770852428964,0.219523373052246,0.530247479376719
"Arkansas",5015,"Carroll County",7424,4023,11797,3401,0.6293125370857,0.34101890311096,0.288293633974739
"Arkansas",5017,"Chicot County",1752,2260,4103,-508,0.427004630757982,0.550816475749452,-0.12381184499147
"Arkansas",5019,"Clark County",4616,3438,8395,1178,0.549851101846337,0.409529481834425,0.140321620011912
"Arkansas",5021,"Clay County",4086,962,5183,3124,0.78834651746093,0.185606791433533,0.602739726027397
"Arkansas",5023,"Cleburne County",10328,1988,12680,8340,0.814511041009464,0.156782334384858,0.657728706624606
"Arkansas",5025,"Cleveland County",2867,651,3600,2216,0.796388888888889,0.180833333333333,0.615555555555556
"Arkansas",5027,"Columbia County",5500,2814,8616,2686,0.638347260909935,0.326601671309192,0.311745589600743
"Arkansas",5029,"Conway County",5694,2615,8685,3079,0.655613126079447,0.301093839953944,0.354519286125504
"Arkansas",5031,"Craighead County",25558,11921,38511,13637,0.663654540261224,0.309547921373114,0.35410661888811
"Arkansas",5033,"Crawford County",18607,4959,24091,13648,0.772363123158026,0.205844506247146,0.56651861691088
"Arkansas",5035,"Crittenden County",7333,8514,16367,-1181,0.448035681554347,0.520193071424207,-0.0721573898698601
"Arkansas",5037,"Cross County",4946,1772,6942,3174,0.712474791126476,0.255257850763469,0.457216940363008
"Arkansas",5039,"Dallas County",1573,963,2649,610,0.593808984522461,0.363533408833522,0.230275575688939
"Arkansas",5041,"Desha County",1921,2016,4164,-95,0.46133525456292,0.484149855907781,-0.0228146013448607
"Arkansas",5043,"Drew County",4349,2426,6908,1923,0.629559930515345,0.351187029530979,0.278372900984366
"Arkansas",5045,"Faulkner County",34421,18347,54428,16074,0.632413463658411,0.337087528477989,0.295325935180422
"Arkansas",5047,"Franklin County",5677,1300,7129,4377,0.796324870248282,0.182353766306635,0.613971103941647
"Arkansas",5049,"Fulton County",3961,1035,5119,2926,0.773783942176206,0.202187927329557,0.57159601484665
"Arkansas",5051,"Garland County",29069,14045,44199,15024,0.657684562999163,0.317767370302496,0.339917192696667
"Arkansas",5053,"Grant County",6794,1268,8200,5526,0.828536585365854,0.154634146341463,0.67390243902439
"Arkansas",5055,"Greene County",12670,3058,16100,9612,0.78695652173913,0.189937888198758,0.597018633540373
"Arkansas",5057,"Hempstead County",4470,2138,6848,2332,0.652745327102804,0.312207943925234,0.34053738317757
"Arkansas",5059,"Hot Spring County",9202,3082,12557,6120,0.732818348331608,0.245440789997611,0.487377558333997
"Arkansas",5061,"Howard County",3367,1340,4834,2027,0.696524617294166,0.277203144393877,0.41932147290029
"Arkansas",5063,"Independence County",11250,2806,14512,8444,0.775220507166483,0.193357221609702,0.581863285556781
"Arkansas",5065,"Izard County",4631,1021,5810,3610,0.797074010327022,0.175731497418244,0.621342512908778
"Arkansas",5067,"Jackson County",3593,1365,5091,2228,0.705755254370458,0.268120212139069,0.437635042231389
"Arkansas",5069,"Jefferson County",9521,14981,25158,-5460,0.378448207329676,0.595476587964067,-0.217028380634391
"Arkansas",5071,"Johnson County",6938,2283,9498,4655,0.730469572541588,0.240366392924826,0.490103179616761
"Arkansas",5073,"Lafayette County",1757,839,2679,918,0.655841731989548,0.31317655841732,0.342665173572228
"Arkansas",5075,"Lawrence County",4569,1080,5857,3489,0.780092197370668,0.184394741335154,0.595697456035513
"Arkansas",5077,"Lee County",1286,1423,2848,-137,0.451544943820225,0.499648876404494,-0.0481039325842697
"Arkansas",5079,"Lincoln County",2729,1032,3875,1697,0.704258064516129,0.266322580645161,0.437935483870968
"Arkansas",5081,"Little River County",3715,1226,5177,2489,0.717597063936643,0.236816689202241,0.480780374734402
"Arkansas",5083,"Logan County",6441,1544,8225,4897,0.783100303951368,0.187720364741641,0.595379939209726
"Arkansas",5085,"Lonoke County",22884,6686,30662,16198,0.746330963407475,0.218054921401083,0.528276042006392
"Arkansas",5087,"Madison County",5658,1563,7351,4095,0.769691198476398,0.212624132771052,0.557067065705346
"Arkansas",5089,"Marion County",5783,1531,7503,4252,0.770758363321338,0.204051712648274,0.566706650673064
"Arkansas",5091,"Miller County",11920,4245,16529,7675,0.721156754794603,0.256821344303951,0.464335410490653
"Arkansas",5093,"Mississippi County",7296,4558,12342,2738,0.591152163344677,0.369308053800032,0.221844109544644
"Arkansas",5095,"Monroe County",1545,1147,2816,398,0.548650568181818,0.407315340909091,0.141335227272727
"Arkansas",5097,"Montgomery County",3046,731,3873,2315,0.786470436354247,0.188742576813839,0.597727859540408
"Arkansas",5099,"Nevada County",2133,1076,3358,1057,0.635199523525908,0.320428826682549,0.314770696843359
"Arkansas",5101,"Newton County",3192,709,3998,2483,0.7983991995998,0.177338669334667,0.621060530265133
"Arkansas",5103,"Ouachita County",5294,3995,9629,1299,0.54979748675875,0.414892512202721,0.134904974556029
"Arkansas",5105,"Perry County",3479,1012,4627,2467,0.751891074130106,0.218716230819105,0.533174843311001
"Arkansas",5107,"Phillips County",2417,3623,6242,-1206,0.387215636014098,0.580422941364947,-0.193207305350849
"Arkansas",5109,"Pike County",3519,644,4246,2875,0.828780028261894,0.151672162034856,0.677107866227037
"Arkansas",5111,"Poinsett County",5918,1424,7521,4494,0.78686344900944,0.189336524398351,0.597526924611089
"Arkansas",5113,"Polk County",7035,1246,8490,5789,0.828621908127208,0.146760895170789,0.681861012956419
"Arkansas",5115,"Pope County",18081,5772,24432,12309,0.740054027504912,0.236247544204322,0.503806483300589
"Arkansas",5117,"Prairie County",2786,654,3495,2132,0.797138769670959,0.187124463519313,0.610014306151645
"Arkansas",5119,"Pulaski County",63687,101947,169956,-38260,0.374726399774059,0.59984348890301,-0.225117089128951
"Arkansas",5121,"Randolph County",5355,1215,6812,4140,0.786112742219612,0.178361714621257,0.607751027598356
"Arkansas",5123,"St. Francis County",3242,3604,7108,-362,0.456105796285875,0.507034327518289,-0.0509285312324142
"Arkansas",5125,"Saline County",39556,16060,56959,23496,0.694464439333556,0.281957197282256,0.4125072420513
"Arkansas",5127,"Scott County",2962,483,3551,2479,0.834131230639257,0.136018023092087,0.69811320754717
"Arkansas",5129,"Searcy County",3365,588,4019,2777,0.837272953471013,0.146305051007713,0.690967902463299
"Arkansas",5131,"Sebastian County",31198,14487,47140,16711,0.661815867628341,0.307318625371235,0.354497242257106
"Arkansas",5133,"Sevier County",3884,1116,5202,2768,0.746635909265667,0.214532871972318,0.532103037293349
"Arkansas",5135,"Sharp County",5938,1398,7566,4540,0.784826856991805,0.1847739888977,0.600052868094105
"Arkansas",5137,"Stone County",4616,1180,5938,3436,0.777366116537555,0.198720107780397,0.578646008757157
"Arkansas",5139,"Union County",10478,5584,16607,4894,0.630938760763534,0.336243752634431,0.294695008129102
"Arkansas",5141,"Van Buren County",6034,1593,7807,4441,0.772896118867683,0.20404764954528,0.568848469322403
"Arkansas",5143,"Washington County",47504,43824,94266,3680,0.503935671397959,0.46489720577939,0.0390384656185687
"Arkansas",5145,"White County",24182,5978,30885,18204,0.782969078840861,0.193556742755383,0.589412336085478
"Arkansas",5147,"Woodruff County",1543,856,2476,687,0.623182552504039,0.345718901453958,0.277463651050081
"Arkansas",5149,"Yell County",5226,1284,6741,3942,0.775255896751224,0.19047619047619,0.584779706275033
"California",6001,"Alameda County",136309,617659,769864,-481350,0.177055947543982,0.802296249727225,-0.625240302183243
"California",6003,"Alpine County",244,476,741,-232,0.329284750337382,0.642375168690958,-0.313090418353576
"California",6005,"Amador County",13585,8153,22302,5432,0.609138193883957,0.365572594386154,0.243565599497803
"California",6007,"Butte County",48730,50426,102042,-1696,0.477548460437859,0.494169067638815,-0.0166206072009565
"California",6009,"Calaveras County",16518,10046,27164,6472,0.608084229126786,0.369827713149757,0.238256515977028
"California",6011,"Colusa County",4554,3234,7951,1320,0.572758143629732,0.406741290403723,0.166016853226009
"California",6013,"Contra Costa County",152877,416386,581230,-263509,0.26302324381054,0.716387660650689,-0.453364416840149
"California",6015,"Del Norte County",6461,4677,11452,1784,0.564180929095355,0.408400279427174,0.15578064966818
"California",6017,"El Dorado County",61838,51621,116138,10217,0.53245277170263,0.444479842945462,0.0879729287571682
"California",6019,"Fresno County",164464,193025,364809,-28561,0.450822211074836,0.529112494483415,-0.0782902834085781
"California",6021,"Glenn County",7063,3995,11292,3068,0.625487070492384,0.353790294013461,0.271696776478923
"California",6023,"Humboldt County",21770,44768,68828,-22998,0.316295693613064,0.650432963328878,-0.334137269715813
"California",6025,"Imperial County",20847,34678,56718,-13831,0.367555273458161,0.611410839592369,-0.243855566134208
"California",6027,"Inyo County",4620,4634,9481,-14,0.487290370214112,0.48876700769961,-0.00147663748549731
"California",6029,"Kern County",164484,133366,305226,31118,0.538892492775845,0.436941807054445,0.1019506857214
"California",6031,"Kings County",24072,18699,43858,5373,0.54886223722012,0.426353230881481,0.122509006338638
"California",6033,"Lake County",13123,14941,28800,-1818,0.455659722222222,0.518784722222222,-0.063125
"California",6035,"Lassen County",8970,2799,11985,6171,0.748435544430538,0.233541927409262,0.514893617021277
"California",6037,"Los Angeles County",1145530,3028885,4263443,-1883355,0.268686599070282,0.710431686315497,-0.441745087245215
"California",6039,"Madera County",29378,23168,53722,6210,0.546852313763449,0.431257213059827,0.115595100703622
"California",6041,"Marin County",24612,128288,155801,-103676,0.157970744732062,0.82340934910559,-0.665438604373528
"California",6043,"Mariposa County",5950,4088,10280,1862,0.578793774319066,0.397665369649805,0.181128404669261
"California",6045,"Mendocino County",13267,28782,43336,-15515,0.306142698910836,0.664159128669005,-0.358016429758169
"California",6047,"Merced County",39397,48991,90541,-9594,0.435128836659635,0.541091881026275,-0.10596304436664
"California",6049,"Modoc County",3109,1150,4338,1959,0.716689718764408,0.265099124020286,0.451590594744122
"California",6051,"Mono County",2513,4013,6737,-1500,0.373014694968087,0.595665726584533,-0.222651031616447
"California",6053,"Monterey County",46299,113953,163883,-67654,0.282512524178835,0.695331425468169,-0.412818901289335
"California",6055,"Napa County",20676,49817,72122,-29141,0.286680901805274,0.690732370150578,-0.404051468345304
"California",6057,"Nevada County",26779,36359,64738,-9580,0.413651950940715,0.561633043961815,-0.1479810930211
"California",6059,"Orange County",676498,814009,1521725,-137511,0.444559956628169,0.534925167162266,-0.0903652105340977
"California",6061,"Placer County",122488,106869,235017,15619,0.521187828965564,0.45472880685227,0.0664590221132939
"California",6063,"Plumas County",6445,4561,11256,1884,0.572583511016347,0.405206112295665,0.167377398720682
"California",6065,"Riverside County",448702,527945,996156,-79243,0.450433466244243,0.529982251775826,-0.0795487855315834
"California",6067,"Sacramento County",259405,440808,718290,-181403,0.36114243550655,0.613690849099946,-0.252548413593395
"California",6069,"San Benito County",10590,17628,28821,-7038,0.367440408035807,0.611637347767253,-0.244196939731446
"California",6071,"San Bernardino County",366257,455859,840931,-89602,0.435537517346845,0.542088470992269,-0.106550953645424
"California",6073,"San Diego County",600094,964650,1601722,-364556,0.374655526989078,0.602258069752429,-0.227602542763351
"California",6075,"San Francisco County",56417,378156,443458,-321739,0.127220616157562,0.852743664563499,-0.725523048405937
"California",6077,"San Joaquin County",121098,161137,288443,-40039,0.419833381291971,0.558644168865252,-0.138810787573281
"California",6079,"San Luis Obispo County",67436,88310,159681,-20874,0.4223169945078,0.55304012374672,-0.13072312923892
"California",6081,"San Mateo County",75563,291410,374138,-215847,0.201965584891136,0.778883727394705,-0.576918142503568
"California",6083,"Santa Barbara County",65736,129963,200288,-64227,0.328207381370826,0.648880611918837,-0.320673230548011
"California",6085,"Santa Clara County",214612,617967,850522,-403355,0.252329745732621,0.72657379820863,-0.474244052476009
"California",6087,"Santa Cruz County",26937,114246,144796,-87309,0.18603414458963,0.78901350866046,-0.602979364070831
"California",6089,"Shasta County",60789,30000,92900,30789,0.654348762109796,0.322927879440258,0.331420882669537
"California",6091,"Sierra County",1142,730,1930,412,0.591709844559586,0.378238341968912,0.213471502590674
"California",6093,"Siskiyou County",13290,9593,23450,3697,0.566737739872068,0.40908315565032,0.157654584221748
"California",6095,"Solano County",69306,131639,205831,-62333,0.336713128731824,0.639548950352474,-0.30283582162065
"California",6097,"Sonoma County",61825,199938,268252,-138113,0.23047358453991,0.745336474658157,-0.514862890118247
"California",6099,"Stanislaus County",104145,105841,214876,-1696,0.484674882257674,0.492567806548893,-0.00789292429121913
"California",6101,"Sutter County",24375,17367,42640,7008,0.571646341463415,0.407293621013133,0.164352720450281
"California",6103,"Tehama County",19141,8911,28721,10230,0.666446154381811,0.310260784791616,0.356185369590195
"California",6105,"Trinity County",3188,2851,6258,337,0.509427932246724,0.45557686161713,0.0538510706295942
"California",6107,"Tulare County",77579,66105,146832,11474,0.528352130325815,0.450208401438379,0.078143728887436
"California",6109,"Tuolumne County",17689,11978,30401,5711,0.581855860004605,0.394000197361929,0.187855662642676
"California",6111,"Ventura County",162207,251388,422698,-89181,0.383742056976849,0.594722473255137,-0.210980416278289
"California",6113,"Yolo County",27292,67598,97264,-40306,0.28059713768712,0.694995064977792,-0.414397927290673
"California",6115,"Yuba County",17676,11230,29787,6446,0.593413233961124,0.377010105079397,0.216403128881727
"Colorado",8001,"Adams County",95657,134202,236735,-38545,0.404067839567449,0.566887025577122,-0.162819186009673
"Colorado",8003,"Alamosa County",3813,3759,7808,54,0.488345286885246,0.481429303278689,0.00691598360655737
"Colorado",8005,"Arapahoe County",127323,213607,350183,-86284,0.363589894426628,0.60998677834161,-0.246396883914982
"Colorado",8007,"Archuleta County",5189,3738,9144,1451,0.567475940507437,0.408792650918635,0.158683289588801
"Colorado",8009,"Baca County",1867,317,2225,1550,0.839101123595506,0.14247191011236,0.696629213483146
"Colorado",8011,"Bent County",1503,732,2274,771,0.660949868073879,0.321899736147757,0.339050131926121
"Colorado",8013,"Boulder County",42501,159089,206111,-116588,0.206204423829878,0.771860793455953,-0.565656369626075
"Colorado",8014,"Broomfield County",16295,29077,46632,-12782,0.3494381540573,0.623541773889175,-0.274103619831875
"Colorado",8015,"Chaffee County",6222,7160,13717,-938,0.453597725450171,0.521980024786761,-0.0683822993365897
"Colorado",8017,"Cheyenne County",993,131,1136,862,0.874119718309859,0.115316901408451,0.758802816901408
"Colorado",8019,"Clear Creek County",2754,3604,6548,-850,0.420586438607208,0.550397067806964,-0.129810629199756
"Colorado",8021,"Conejos County",2286,1959,4333,327,0.527579044541888,0.452111700900069,0.0754673436418186
"Colorado",8023,"Costilla County",741,1311,2094,-570,0.353868194842407,0.626074498567335,-0.272206303724928
"Colorado",8025,"Crowley County",1271,437,1750,834,0.726285714285714,0.249714285714286,0.476571428571429
"Colorado",8027,"Custer County",2474,1112,3634,1362,0.680792515134838,0.305998899284535,0.374793615850303
"Colorado",8029,"Delta County",13081,5887,19370,7194,0.675322663913268,0.303923593185338,0.37139907072793
"Colorado",8031,"Denver County",71618,313293,393827,-241675,0.181851422071112,0.795509195662055,-0.613657773590942
"Colorado",8033,"Dolores County",1089,341,1449,748,0.751552795031056,0.235334713595583,0.516218081435473
"Colorado",8035,"Douglas County",121270,104653,231599,16617,0.52362056830988,0.451871553849542,0.0717490144603388
"Colorado",8037,"Eagle County",9892,18588,29140,-8696,0.339464653397392,0.637886067261496,-0.298421413864104
"Colorado",8039,"Elbert County",14027,4490,18983,9537,0.738924300690091,0.236527419269873,0.502396881420218
"Colorado",8041,"El Paso County",202828,161941,378849,40887,0.535379531158852,0.427455265818308,0.107924265340545
"Colorado",8043,"Fremont County",17517,7369,25557,10148,0.685409085573424,0.28833587666784,0.397073208905584
"Colorado",8045,"Garfield County",14717,15427,30904,-710,0.476216670981103,0.49919104323065,-0.022974372249547
"Colorado",8047,"Gilpin County",1833,2223,4186,-390,0.437888198757764,0.531055900621118,-0.093167701863354
"Colorado",8049,"Grand County",4883,4710,9870,173,0.494731509625127,0.477203647416413,0.0175278622087133
"Colorado",8051,"Gunnison County",3735,7132,11190,-3397,0.333780160857909,0.637354781054513,-0.303574620196604
"Colorado",8053,"Hinsdale County",353,255,632,98,0.558544303797468,0.403481012658228,0.15506329113924
"Colorado",8055,"Huerfano County",2203,2076,4406,127,0.5,0.471175669541534,0.0288243304584657
"Colorado",8057,"Jackson County",681,175,876,506,0.777397260273973,0.199771689497717,0.577625570776256
"Colorado",8059,"Jefferson County",148417,218396,377357,-69979,0.393306603561084,0.57875168606916,-0.185445082508076
"Colorado",8061,"Kiowa County",795,98,903,697,0.880398671096346,0.108527131782946,0.7718715393134
"Colorado",8063,"Kit Carson County",3144,662,3871,2482,0.812193231723069,0.171015241539654,0.641177990183415
"Colorado",8065,"Lake County",1497,2303,3961,-806,0.377934864933098,0.581418833627872,-0.203483968694774
"Colorado",8067,"La Plata County",14233,20548,35667,-6315,0.399052345305184,0.576106765357333,-0.177054420052149
"Colorado",8069,"Larimer County",91489,126120,224338,-34631,0.407817667983133,0.562187413634783,-0.154369745651651
"Colorado",8071,"Las Animas County",4284,3497,7961,787,0.538123351337772,0.439266423816103,0.0988569275216682
"Colorado",8073,"Lincoln County",2135,470,2651,1665,0.805356469256884,0.17729158807997,0.628064881176914
"Colorado",8075,"Logan County",8087,2218,10532,5869,0.767850360805165,0.210596278009875,0.557254082795291
"Colorado",8077,"Mesa County",56894,31536,90622,25358,0.627816644964799,0.347994968109289,0.27982167685551
"Colorado",8079,"Mineral County",427,317,756,110,0.564814814814815,0.419312169312169,0.145502645502645
"Colorado",8081,"Moffat County",5670,1203,7026,4467,0.807002561912895,0.171221178479932,0.635781383432963
"Colorado",8083,"Montezuma County",9306,5836,15500,3470,0.600387096774194,0.376516129032258,0.223870967741935
"Colorado",8085,"Montrose County",16770,7687,24922,9083,0.67289944627237,0.308442340101115,0.364457106171254
"Colorado",8087,"Morgan County",9593,3876,13744,5717,0.697977299185099,0.282013969732247,0.415963329452852
"Colorado",8089,"Otero County",5756,3605,9576,2151,0.60108604845447,0.376461988304094,0.224624060150376
"Colorado",8091,"Ouray County",1577,2365,4020,-788,0.39228855721393,0.588308457711443,-0.196019900497512
"Colorado",8093,"Park County",6991,4903,12290,2088,0.568836452400325,0.398942229454841,0.169894222945484
"Colorado",8095,"Phillips County",1958,486,2485,1472,0.787927565392354,0.195573440643863,0.592354124748491
"Colorado",8097,"Pitkin County",2780,8989,11957,-6209,0.232499790917454,0.751777201639207,-0.519277410721753
"Colorado",8099,"Prowers County",4008,1458,5561,2550,0.720733680992627,0.262183060600611,0.458550620392016
"Colorado",8101,"Pueblo County",42252,43772,88299,-1520,0.478510515407876,0.495724753394716,-0.0172142379868401
"Colorado",8103,"Rio Blanco County",3061,561,3691,2500,0.829314548902736,0.151991330262801,0.677323218639935
"Colorado",8105,"Rio Grande County",3660,2495,6305,1165,0.580491673275178,0.395717684377478,0.1847739888977
"Colorado",8107,"Routt County",5925,10582,16876,-4657,0.351090305759659,0.62704432329936,-0.275954017539701
"Colorado",8109,"Saguache County",1413,1884,3389,-471,0.416937149601652,0.55591619946887,-0.138979049867217
"Colorado",8111,"San Juan County",202,342,563,-140,0.358792184724689,0.607460035523979,-0.24866785079929
"Colorado",8113,"San Miguel County",1136,3924,5147,-2788,0.220711093841072,0.762385855838352,-0.54167476199728
"Colorado",8115,"Sedgwick County",1121,301,1446,820,0.775242047026279,0.208160442600277,0.567081604426003
"Colorado",8117,"Summit County",5322,12631,18479,-7309,0.288002597543157,0.683532658693652,-0.395530061150495
"Colorado",8119,"Teller County",11241,5278,16939,5963,0.663616506287266,0.311588641596316,0.35202786469095
"Colorado",8121,"Washington County",2595,369,3008,2226,0.862699468085106,0.122672872340426,0.740026595744681
"Colorado",8123,"Weld County",96145,66060,166968,30085,0.575828901346366,0.395644674428633,0.180184226917733
"Colorado",8125,"Yuma County",4107,785,4981,3322,0.824533226259787,0.157598875727766,0.666934350532022
"Connecticut",9001,"Fairfield County",169039,297505,472990,-128466,0.35738387703757,0.628987927863168,-0.271604050825599
"Connecticut",9003,"Hartford County",159024,283368,449336,-124344,0.353908878879057,0.630637206900849,-0.276728328021792
"Connecticut",9005,"Litchfield County",55601,50164,107544,5437,0.517006992486796,0.466450941010191,0.050556051476605
"Connecticut",9007,"Middlesex County",40665,56848,99203,-16183,0.40991703879923,0.573047186073002,-0.163130147273772
"Connecticut",9009,"New Haven County",169892,242629,417980,-72737,0.406459639217187,0.580479927269247,-0.17402028805206
"Connecticut",9011,"New London County",57110,79459,139604,-22349,0.409085699550156,0.569174235695252,-0.160088536145096
"Connecticut",9013,"Tolland County",34819,44006,80546,-9187,0.432287140267673,0.546346187271869,-0.114059047004196
"Connecticut",9015,"Windham County",29141,26701,57077,2440,0.510555915692836,0.467806647160853,0.0427492685319831
"Delaware",10001,"Kent County",41009,44552,87025,-3543,0.471232404481471,0.511944843435794,-0.0407124389543234
"Delaware",10003,"New Castle County",88364,195034,287633,-106670,0.307210925032941,0.678065451460716,-0.370854526427774
"Delaware",10005,"Sussex County",71230,56682,129352,14548,0.550667944832705,0.438199641288886,0.112468303543818
"District of Columbia",11001,"District of Columbia",18586,317323,344356,-298737,0.053973213767148,0.921496939214069,-0.867523725446921
"Florida",12001,"Alachua County",50972,89704,142604,-38732,0.357437379035651,0.629042663599899,-0.271605284564248
"Florida",12003,"Baker County",11911,2037,14059,9874,0.847215306920834,0.14488939469379,0.702325912227043
"Florida",12005,"Bay County",66097,25614,93024,40483,0.710537065703474,0.275348297213622,0.435188768489852
"Florida",12007,"Bradford County",10334,3160,13632,7174,0.758069248826291,0.231807511737089,0.526261737089202
"Florida",12009,"Brevard County",207883,148549,360764,59334,0.576229889900323,0.41176226009247,0.164467629807852
"Florida",12011,"Broward County",333409,618752,957672,-285343,0.348145294004628,0.646100126139221,-0.297954832134593
"Florida",12013,"Calhoun County",5274,1209,6526,4065,0.808152007355195,0.185258964143426,0.622893043211768
"Florida",12015,"Charlotte County",73243,42273,116340,30970,0.629559910606842,0.363357400722022,0.26620250988482
"Florida",12017,"Citrus County",65352,27092,93208,38260,0.70114153291563,0.290661745772895,0.410479787142734
"Florida",12019,"Clay County",84480,38317,124405,46163,0.67907238455046,0.308002089948153,0.371070294602307
"Florida",12021,"Collier County",128950,77621,207818,51329,0.62049485607599,0.37350470122896,0.24699015484703
"Florida",12023,"Columbia County",23836,8914,33042,14922,0.721384904061497,0.269777858483143,0.451607045578355
"Florida",12027,"DeSoto County",8313,4259,12659,4054,0.656686942096532,0.336440477130895,0.320246464965637
"Florida",12029,"Dixie County",6759,1365,8167,5394,0.827598873515367,0.167136035263867,0.6604628382515
"Florida",12031,"Duval County",233762,252556,492820,-18794,0.474335457164888,0.512471084777404,-0.0381356276125158
"Florida",12033,"Escambia County",96674,70929,170372,25745,0.567428920245111,0.41631840912826,0.15111051111685
"Florida",12035,"Flagler County",43043,28161,71716,14882,0.600186848123152,0.39267388030565,0.207512967817502
"Florida",12037,"Franklin County",4675,2120,6849,2555,0.682581398744342,0.309534238574974,0.373047160169368
"Florida",12039,"Gadsden County",7465,16153,23762,-8688,0.314157057486744,0.679782846561737,-0.365625789074994
"Florida",12041,"Gilchrist County",7895,1700,9685,6195,0.815178110480124,0.175529168817759,0.639648941662365
"Florida",12043,"Glades County",3782,1385,5193,2397,0.728288080107838,0.266705180050067,0.46158290005777
"Florida",12045,"Gulf County",6113,1985,8163,4128,0.748866838172241,0.243170403038099,0.505696435134142
"Florida",12047,"Hamilton County",3815,1963,5830,1852,0.654373927958834,0.336706689536878,0.317667238421955
"Florida",12049,"Hardee County",6122,2298,8485,3824,0.721508544490277,0.270830878020035,0.450677666470242
"Florida",12051,"Hendry County",7906,4929,12940,2977,0.61097372488408,0.380911901081917,0.230061823802164
"Florida",12053,"Hernando County",70412,37519,108922,32893,0.646444244505242,0.344457501698463,0.301986742806779
"Florida",12055,"Highlands County",34873,16938,52170,17935,0.668449300364194,0.324669350201265,0.343779950162929
"Florida",12057,"Hillsborough County",327398,376367,712063,-48969,0.459787968199443,0.528558568553625,-0.0687706003541821
"Florida",12059,"Holmes County",8080,924,9068,7156,0.891045434494927,0.101896779885311,0.789148654609616
"Florida",12061,"Indian River County",58872,37844,97484,21028,0.603914488531451,0.388207295556194,0.215707192975258
"Florida",12063,"Jackson County",15488,6766,22419,8722,0.690842588875507,0.301797582407779,0.389045006467728
"Florida",12065,"Jefferson County",4479,3897,8451,582,0.529996450124246,0.461128860489883,0.0688675896343628
"Florida",12067,"Lafayette County",3128,510,3658,2618,0.855112083105522,0.139420448332422,0.7156916347731
"Florida",12069,"Lake County",125859,83505,211314,42354,0.595601805843437,0.395170220619552,0.200431585223885
"Florida",12071,"Lee County",233247,157695,393899,75552,0.592149256535305,0.40034374293918,0.191805513596125
"Florida",12073,"Leon County",57453,103517,162929,-46064,0.352625990462103,0.63535036733792,-0.282724376875817
"Florida",12075,"Levy County",16749,6205,23145,10544,0.723655217109527,0.268092460574638,0.455562756534889
"Florida",12077,"Liberty County",2846,694,3561,2152,0.799213704015726,0.194889076102218,0.604324627913507
"Florida",12079,"Madison County",5576,3747,9380,1829,0.594456289978678,0.399466950959488,0.19498933901919
"Florida",12081,"Manatee County",124987,90166,216958,34821,0.57608845951751,0.415591957890467,0.160496501627043
"Florida",12083,"Marion County",127826,74858,204376,52968,0.625445257760207,0.366275883665401,0.259169374094806
"Florida",12085,"Martin County",61168,36893,98726,24275,0.619573364665843,0.373690821060308,0.245882543605534
"Florida",12086,"Miami-Dade County",532833,617864,1156816,-85031,0.460603069113844,0.534107412068989,-0.0735043429551459
"Florida",12087,"Monroe County",25693,21881,48029,3812,0.534947635803369,0.455578921068521,0.0793687147348477
"Florida",12089,"Nassau County",42566,15564,58811,27002,0.723776164323001,0.26464436925065,0.45913179507235
"Florida",12091,"Okaloosa County",79798,34248,116373,45550,0.685708884363211,0.294295068443711,0.3914138159195
"Florida",12093,"Okeechobee County",11470,4390,15954,7080,0.718941958129623,0.275166102544816,0.443775855584806
"Florida",12095,"Orange County",245398,395014,647403,-149616,0.37904983449258,0.610151636615833,-0.231101802123252
"Florida",12097,"Osceola County",73480,97297,172436,-23817,0.426129114570043,0.56424992460971,-0.138120810039667
"Florida",12099,"Palm Beach County",334711,433572,773158,-98861,0.432914100352063,0.560780590771873,-0.127866490419811
"Florida",12101,"Pasco County",179621,119073,301970,60548,0.594830612312481,0.394320627876941,0.20050998443554
"Florida",12103,"Pinellas County",276209,277450,559715,-1241,0.493481503979704,0.495698703804615,-0.00221719982491086
"Florida",12105,"Polk County",194586,145049,343256,49537,0.566883026079661,0.422567995898105,0.144315030181555
"Florida",12107,"Putnam County",25514,10527,36373,14987,0.701454375498309,0.289417974871471,0.412036400626839
"Florida",12109,"St. Johns County",110946,63850,176622,47096,0.628155042973129,0.361506494094733,0.266648548878396
"Florida",12111,"St. Lucie County",86831,84137,172169,2694,0.504335856048418,0.488688439846895,0.0156474162015229
"Florida",12113,"Santa Rosa County",77385,27612,106928,49773,0.723711282358222,0.258229836899596,0.465481445458626
"Florida",12115,"Sarasota County",148370,120110,270575,28260,0.548350734546799,0.443906495426407,0.104444239120392
"Florida",12117,"Seminole County",125241,132528,260815,-7287,0.48019093993827,0.508130283917719,-0.027939343979449
"Florida",12119,"Sumter County",62761,29341,92485,33420,0.678607341731091,0.317251446180462,0.36135589555063
"Florida",12121,"Suwannee County",16410,4485,21057,11925,0.779313292491808,0.212993303889443,0.566319988602365
"Florida",12123,"Taylor County",7751,2299,10127,5452,0.765379678088279,0.227016885553471,0.538362792534808
"Florida",12125,"Union County",5133,1053,6245,4080,0.821937550040032,0.168614891913531,0.653322658126501
"Florida",12127,"Volusia County",173821,130575,307439,43246,0.565383702132781,0.424718399422324,0.140665302710456
"Florida",12129,"Wakulla County",12874,5351,18404,7523,0.699521843077592,0.290752010432515,0.408769832645077
"Florida",12131,"Walton County",32947,10338,43711,22609,0.753746196609549,0.236507972821487,0.517238223788063
"Florida",12133,"Washington County",9876,2347,12327,7529,0.801168167437333,0.190395067737487,0.610773099699846
"Georgia",13001,"Appling County",6570,1784,8390,4786,0.783075089392133,0.212634088200238,0.570441001191895
"Georgia",13003,"Atkinson County",2300,825,3155,1475,0.729001584786054,0.26148969889065,0.467511885895404
"Georgia",13005,"Bacon County",4017,625,4667,3392,0.860724233983287,0.133919005785301,0.726805228197986
"Georgia",13007,"Baker County",897,652,1555,245,0.576848874598071,0.419292604501608,0.157556270096463
"Georgia",13009,"Baldwin County",8903,9140,18251,-237,0.487808887184264,0.500794477014958,-0.0129855898306942
"Georgia",13011,"Banks County",7795,932,8801,6863,0.885694807408249,0.105897057152596,0.779797750255653
"Georgia",13013,"Barrow County",26804,10453,37921,16351,0.706837899844413,0.275652013396271,0.431185886448142
"Georgia",13015,"Bartow County",37672,12091,50464,25581,0.746512365250476,0.239596544071021,0.506915821179455
"Georgia",13017,"Ben Hill County",4111,2393,6564,1718,0.62629494210847,0.364564290067032,0.261730652041438
"Georgia",13019,"Berrien County",6419,1269,7743,5150,0.829006844892161,0.163889965129795,0.665116879762366
"Georgia",13021,"Bibb County",26559,43408,70714,-16849,0.375583335690245,0.613852985264587,-0.238269649574342
"Georgia",13023,"Bleckley County",4329,1312,5708,3017,0.758409250175193,0.229852838121934,0.528556412053259
"Georgia",13025,"Brantley County",6993,700,7749,6293,0.902439024390244,0.0903342366757001,0.812104787714544
"Georgia",13027,"Brooks County",4261,2791,7101,1470,0.600056330094353,0.393043233347416,0.207013096746937
"Georgia",13029,"Bryan County",14240,6738,21335,7502,0.667447855636278,0.315819076634638,0.35162877900164
"Georgia",13031,"Bulloch County",18387,11248,30090,7139,0.611066799601196,0.373811897640412,0.237254901960784
"Georgia",13033,"Burke County",5400,5208,10683,192,0.50547598989048,0.48750351024993,0.0179724796405504
"Georgia",13035,"Butts County",8406,3274,11771,5132,0.71412794155127,0.278141194460963,0.435986747090307
"Georgia",13037,"Calhoun County",923,1263,2198,-340,0.41992720655141,0.574613284804368,-0.154686078252957
"Georgia",13039,"Camden County",15249,7967,23686,7282,0.643798024149287,0.336359030651017,0.307438993498269
"Georgia",13043,"Candler County",3133,1269,4431,1864,0.707063868201309,0.286391333784699,0.42067253441661
"Georgia",13045,"Carroll County",37476,16236,54472,21240,0.687986488471141,0.298061389337641,0.3899250991335
"Georgia",13047,"Catoosa County",25167,6932,32593,18235,0.772159666185991,0.21268370509005,0.559475961095941
"Georgia",13049,"Charlton County",3419,1105,4568,2314,0.748467600700525,0.241900175131349,0.506567425569177
"Georgia",13051,"Chatham County",53232,78247,133408,-25015,0.39901655073159,0.586524046533941,-0.187507495802351
"Georgia",13053,"Chattahoochee County",880,667,1582,213,0.556257901390645,0.421618204804045,0.134639696586599
"Georgia",13055,"Chattooga County",8064,1854,10050,6210,0.802388059701493,0.184477611940298,0.617910447761194
"Georgia",13057,"Cherokee County",99585,42779,144815,56806,0.687670476124711,0.295404481579947,0.392265994544764
"Georgia",13059,"Clarke County",14450,36055,51346,-21605,0.281424064191953,0.702196860514938,-0.420772796322985
"Georgia",13061,"Clay County",637,791,1435,-154,0.44390243902439,0.551219512195122,-0.107317073170732
"Georgia",13063,"Clayton County",15811,95466,112330,-79655,0.140754918543577,0.849870916050921,-0.709115997507344
"Georgia",13065,"Clinch County",2105,744,2861,1361,0.735756728416638,0.260048933939182,0.475707794477455
"Georgia",13067,"Cobb County",165436,221847,393728,-56411,0.420178397269181,0.56345243416775,-0.14327403689857
"Georgia",13069,"Coffee County",10578,4511,15214,6067,0.695280662547654,0.29650322071776,0.398777441829894
"Georgia",13071,"Colquitt County",11777,4190,16086,7587,0.73212731567823,0.26047494715902,0.471652368519209
"Georgia",13073,"Columbia County",50013,29232,80575,20781,0.620701210052746,0.36279242941359,0.257908780639156
"Georgia",13075,"Cook County",4900,2059,7035,2841,0.696517412935323,0.292679459843639,0.403837953091684
"Georgia",13077,"Coweta County",51501,24210,76799,27291,0.670594669201422,0.315238479667704,0.355356189533718
"Georgia",13079,"Crawford County",4428,1615,6102,2813,0.725663716814159,0.264667322189446,0.460996394624713
"Georgia",13081,"Crisp County",4985,2982,8033,2003,0.620565168679198,0.37121872276858,0.249346445910619
"Georgia",13083,"Dade County",6066,1261,7434,4805,0.815980629539952,0.169626042507398,0.646354587032553
"Georgia",13085,"Dawson County",13398,2486,16081,10912,0.833157141968783,0.154592376096014,0.678564765872769
"Georgia",13087,"Decatur County",6755,4782,11625,1973,0.581075268817204,0.411354838709677,0.169720430107527
"Georgia",13089,"DeKalb County",58377,308162,370746,-249785,0.157458205887589,0.831194402636846,-0.673736196749257
"Georgia",13091,"Dodge County",5843,2172,8071,3671,0.723949944244827,0.269111634246066,0.454838309998761
"Georgia",13093,"Dooly County",2159,1911,4105,248,0.525943970767357,0.465529841656517,0.0604141291108404
"Georgia",13095,"Dougherty County",10441,24568,35287,-14127,0.295888004080823,0.696233740470995,-0.400345736390172
"Georgia",13097,"Douglas County",25454,42814,69106,-17360,0.368332706277313,0.619540994993199,-0.251208288715886
"Georgia",13099,"Early County",2710,2450,5188,260,0.522359290670779,0.472243639167309,0.0501156515034695
"Georgia",13101,"Echols County",1256,167,1441,1089,0.871616932685635,0.11589174184594,0.755725190839695
"Georgia",13103,"Effingham County",23361,7718,31571,15643,0.739951221057299,0.244464856989009,0.49548636406829
"Georgia",13105,"Elbert County",6226,2879,9171,3347,0.6788790753462,0.313924326681932,0.364954748664268
"Georgia",13107,"Emanuel County",6553,2886,9505,3667,0.6894266175697,0.303629668595476,0.385796948974224
"Georgia",13109,"Evans County",2888,1324,4247,1564,0.680009418412997,0.311749470214269,0.368259948198728
"Georgia",13111,"Fannin County",12169,2570,14849,9599,0.81951646575527,0.173075627988417,0.646440837766853
"Georgia",13113,"Fayette County",37956,33062,71994,4894,0.527210600883407,0.459232713837264,0.0679778870461428
"Georgia",13115,"Floyd County",28906,11917,41341,16989,0.699209017682204,0.288261048353934,0.41094796932827
"Georgia",13117,"Forsyth County",85123,42208,129311,42915,0.65828119804193,0.326406879538477,0.331874318503453
"Georgia",13119,"Franklin County",9069,1593,10765,7476,0.842452392011147,0.147979563399907,0.69447282861124
"Georgia",13121,"Fulton County",137247,380212,523779,-242965,0.262032269334968,0.725901572991662,-0.463869303656695
"Georgia",13123,"Gilmer County",13429,2932,16525,10497,0.812647503782148,0.177428139183056,0.635219364599092
"Georgia",13125,"Glascock County",1402,155,1565,1247,0.895846645367412,0.0990415335463259,0.796805111821086
"Georgia",13127,"Glynn County",25617,15882,41988,9735,0.610102886539011,0.37825092883681,0.231851957702201
"Georgia",13129,"Gordon County",19405,4384,24033,15021,0.807431448425082,0.182415844879957,0.625015603545125
"Georgia",13131,"Grady County",7034,3619,10707,3415,0.65695339497525,0.338003175492668,0.318950219482582
"Georgia",13133,"Greene County",7066,4087,11244,2979,0.628424048381359,0.363482746353611,0.264941302027748
"Georgia",13135,"Gwinnett County",166400,241994,414023,-75594,0.401910038814269,0.584494098153967,-0.182584059339698
"Georgia",13137,"Habersham County",16637,3562,20431,13075,0.814301796289952,0.174342910283393,0.639958886006559
"Georgia",13139,"Hall County",64183,25033,90537,39150,0.708914587406254,0.276494692777538,0.432419894628715
"Georgia",13141,"Hancock County",1154,2976,4153,-1822,0.277871418251866,0.716590416566338,-0.438718998314471
"Georgia",13143,"Haralson County",12330,1791,14246,10539,0.865506106977397,0.125719500210585,0.739786606766812
"Georgia",13145,"Harris County",14319,5457,19991,8862,0.716272322545145,0.272972837777,0.443299484768146
"Georgia",13147,"Hart County",9465,3157,12728,6308,0.743636077938403,0.248035826524199,0.495600251414205
"Georgia",13149,"Heard County",4519,824,5394,3695,0.837782721542455,0.152762328513163,0.685020393029292
"Georgia",13151,"Henry County",48259,73443,122998,-25184,0.392355973267858,0.597107270036911,-0.204751296769053
"Georgia",13153,"Houston County",41540,32239,74838,9301,0.555065608380769,0.430783826398354,0.124281781982415
"Georgia",13155,"Irwin County",3134,1008,4168,2126,0.751919385796545,0.241842610364683,0.510076775431862
"Georgia",13157,"Jackson County",29502,7642,37675,21860,0.783065693430657,0.202840079628401,0.580225613802256
"Georgia",13159,"Jasper County",5822,1761,7644,4061,0.761643118785976,0.230376766091052,0.531266352694924
"Georgia",13161,"Jeff Davis County",4695,1028,5771,3667,0.813550511176573,0.178132039507884,0.635418471668688
"Georgia",13163,"Jefferson County",3537,4058,7639,-521,0.463018719727713,0.531221364052887,-0.0682026443251735
"Georgia",13165,"Jenkins County",2161,1266,3455,895,0.625470332850941,0.366425470332851,0.25904486251809
"Georgia",13167,"Johnson County",2850,1222,4100,1628,0.695121951219512,0.298048780487805,0.397073170731707
"Georgia",13169,"Jones County",9940,4882,14934,5058,0.665595285924735,0.326905048881746,0.338690237042989
"Georgia",13171,"Lamar County",6331,2620,9045,3711,0.699944720840243,0.289662797125484,0.410281923714759
"Georgia",13173,"Lanier County",2509,1019,3576,1490,0.70162192393736,0.284955257270693,0.416666666666667
"Georgia",13175,"Laurens County",14493,8074,22731,6419,0.637587435660552,0.355197747569399,0.282389688091153
"Georgia",13177,"Lee County",12007,4558,16714,7449,0.718379801364126,0.272705516333613,0.445674285030513
"Georgia",13179,"Liberty County",7959,13104,21394,-5145,0.372020192577358,0.612508179863513,-0.240487987286155
"Georgia",13181,"Lincoln County",3173,1432,4641,1741,0.683688860159448,0.308554190907132,0.375134669252316
"Georgia",13183,"Long County",3527,2035,5657,1492,0.623475340286371,0.35973130634612,0.263744033940251
"Georgia",13185,"Lowndes County",25692,20116,46355,5576,0.554244418077877,0.433955344623018,0.120289073454859
"Georgia",13187,"Lumpkin County",12163,3126,15531,9037,0.783143390638079,0.201274869615608,0.581868521022471
"Georgia",13189,"McDuffie County",6169,4168,10455,2001,0.590052606408417,0.398660927785748,0.191391678622669
"Georgia",13191,"McIntosh County",4016,2612,6696,1404,0.599761051373955,0.390083632019116,0.209677419354839
"Georgia",13193,"Macon County",1783,2858,4663,-1075,0.38237186360712,0.612910143684323,-0.230538280077204
"Georgia",13195,"Madison County",11326,3411,14937,7915,0.758251322219991,0.22835910825467,0.529892213965321
"Georgia",13197,"Marion County",2275,1312,3625,963,0.627586206896552,0.361931034482759,0.265655172413793
"Georgia",13199,"Meriwether County",6524,4287,10877,2237,0.599797738346971,0.39413441206215,0.205663326284821
"Georgia",13201,"Miller County",2066,748,2834,1318,0.729004940014114,0.26393789696542,0.465067043048694
"Georgia",13205,"Mitchell County",4935,3993,8962,942,0.550658335193037,0.44554786877929,0.105110466413747
"Georgia",13207,"Monroe County",11057,4385,15590,6672,0.709236690186017,0.281270044900577,0.427966645285439
"Georgia",13209,"Montgomery County",2960,980,3967,1980,0.746155785228132,0.247038064028233,0.499117721199899
"Georgia",13211,"Morgan County",8231,3353,11706,4878,0.703143686998121,0.286434307192893,0.416709379805228
"Georgia",13213,"Murray County",12944,2301,15389,10643,0.841120280719995,0.149522386119956,0.691597894600039
"Georgia",13215,"Muscogee County",30107,49446,80514,-19339,0.373934967831682,0.614129219763023,-0.240194251931341
"Georgia",13217,"Newton County",23869,29789,54234,-5920,0.440111369251761,0.549267986871704,-0.109156617619943
"Georgia",13219,"Oconee County",16595,8162,25168,8433,0.659369040050858,0.324300699300699,0.335068340750159
"Georgia",13221,"Oglethorpe County",5592,2439,8133,3153,0.687569162670601,0.299889339727038,0.387679822943563
"Georgia",13223,"Paulding County",54517,29695,85372,24822,0.638581736400693,0.34783067047744,0.290751065923254
"Georgia",13225,"Peach County",6506,5922,12553,584,0.518282482275153,0.471759738707879,0.0465227435672748
"Georgia",13227,"Pickens County",14110,2824,17167,11286,0.82192578784878,0.164501660161939,0.657424127686841
"Georgia",13229,"Pierce County",7898,1100,9047,6798,0.872996573449762,0.121587266497181,0.751409306952581
"Georgia",13231,"Pike County",9127,1505,10720,7622,0.851399253731343,0.140391791044776,0.711007462686567
"Georgia",13233,"Polk County",13587,3657,17396,9930,0.781041618762934,0.210220740400092,0.570820878362842
"Georgia",13235,"Pulaski County",2815,1230,4081,1585,0.689781916197011,0.301396716491056,0.388385199705954
"Georgia",13237,"Putnam County",8291,3448,11855,4843,0.699367355546183,0.290847743568115,0.408519611978068
"Georgia",13239,"Quitman County",604,497,1106,107,0.546112115732369,0.449367088607595,0.096745027124774
"Georgia",13241,"Rabun County",7474,1984,9568,5490,0.781145484949833,0.207357859531773,0.57378762541806
"Georgia",13243,"Randolph County",1390,1671,3073,-281,0.452326716563619,0.54376830458835,-0.0914415880247315
"Georgia",13245,"Richmond County",26780,59119,87009,-32339,0.307784252203795,0.67945844682734,-0.371674194623545
"Georgia",13247,"Rockdale County",13014,31237,44681,-18223,0.291264743403236,0.699111479152212,-0.407846735748976
"Georgia",13249,"Schley County",1800,462,2275,1338,0.791208791208791,0.203076923076923,0.588131868131868
"Georgia",13251,"Screven County",3915,2661,6627,1254,0.590765052059755,0.401539157990041,0.189225894069715
"Georgia",13253,"Seminole County",2613,1256,3888,1357,0.672067901234568,0.323045267489712,0.349022633744856
"Georgia",13255,"Spalding County",18104,11828,30211,6276,0.599251928105657,0.391513025057098,0.207738903048558
"Georgia",13257,"Stephens County",9367,2386,11885,6981,0.788136306268406,0.200757257046698,0.587379049221708
"Georgia",13259,"Stewart County",801,1182,1990,-381,0.40251256281407,0.593969849246231,-0.191457286432161
"Georgia",13261,"Sumter County",5733,6314,12148,-581,0.471929535726046,0.519756338491933,-0.0478268027658874
"Georgia",13263,"Talbot County",1392,2114,3522,-722,0.395229982964225,0.60022714366837,-0.204997160704145
"Georgia",13265,"Taliaferro County",360,561,928,-201,0.387931034482759,0.604525862068966,-0.216594827586207
"Georgia",13267,"Tattnall County",6054,2062,8185,3992,0.739645693341478,0.251924251679902,0.487721441661576
"Georgia",13269,"Taylor County",2420,1388,3842,1032,0.629880270692348,0.361270171785528,0.268610098906819
"Georgia",13271,"Telfair County",2825,1488,4334,1337,0.651822796492847,0.343331795108445,0.308491001384402
"Georgia",13273,"Terrell County",2004,2376,4416,-372,0.453804347826087,0.53804347826087,-0.0842391304347825
"Georgia",13275,"Thomas County",12969,8708,21872,4261,0.592949890270666,0.398134601316752,0.194815288953914
"Georgia",13277,"Tift County",10784,5318,16279,5466,0.662448553350943,0.326678542908041,0.335770010442902
"Georgia",13279,"Toombs County",7873,2938,10914,4935,0.721367051493495,0.269195528678761,0.452171522814733
"Georgia",13281,"Towns County",6384,1550,7979,4834,0.800100263190876,0.194259932322346,0.60584033086853
"Georgia",13283,"Treutlen County",2101,952,3077,1149,0.682807929801755,0.30939226519337,0.373415664608385
"Georgia",13285,"Troup County",18142,11577,30047,6565,0.603787399740407,0.385296369021866,0.218491030718541
"Georgia",13287,"Turner County",2349,1409,3791,940,0.619625428646795,0.371669744130836,0.247955684515959
"Georgia",13289,"Twiggs County",2370,2044,4444,326,0.533303330333033,0.45994599459946,0.0733573357335734
"Georgia",13291,"Union County",12650,2800,15558,9850,0.813086514976218,0.179971718729914,0.633114796246304
"Georgia",13293,"Upson County",8606,4203,12905,4403,0.666873304920573,0.325687717938783,0.34118558698179
"Georgia",13295,"Walker County",23173,5770,29354,17403,0.789432445322614,0.19656605573346,0.592866389589153
"Georgia",13297,"Walton County",37839,12683,51093,25156,0.740590687569726,0.248233613215118,0.492357074354608
"Georgia",13299,"Ware County",9903,4169,14189,5734,0.697935020085982,0.293819155683981,0.404115864402002
"Georgia",13301,"Warren County",1166,1468,2650,-302,0.44,0.553962264150943,-0.113962264150943
"Georgia",13303,"Washington County",4668,4743,9477,-75,0.492560937005382,0.500474833808167,-0.0079138968027857
"Georgia",13305,"Wayne County",9987,2688,12779,7299,0.781516550590813,0.210345097425464,0.571171453165349
"Georgia",13307,"Webster County",748,640,1391,108,0.537742631200575,0.460100647016535,0.0776419841840402
"Georgia",13309,"Wheeler County",1583,689,2285,894,0.692778993435449,0.301531728665208,0.391247264770241
"Georgia",13311,"White County",12222,2411,14816,9811,0.824919006479482,0.162729481641469,0.662189524838013
"Georgia",13313,"Whitfield County",25644,10680,36766,14964,0.697492248272861,0.290485774900723,0.407006473372137
"Georgia",13315,"Wilcox County",2402,861,3279,1541,0.732540408661177,0.262580054894785,0.469960353766392
"Georgia",13317,"Wilkes County",2823,2160,5030,663,0.561232604373757,0.429423459244533,0.131809145129225
"Georgia",13319,"Wilkinson County",2665,2074,4770,591,0.558700209643606,0.434800838574423,0.123899371069182
"Georgia",13321,"Worth County",6830,2395,9285,4435,0.735595045772752,0.257942918686053,0.477652127086699
"Hawaii",15001,"Hawaii County",26897,58731,87814,-31834,0.306295123784362,0.668811351265174,-0.362516227480812
"Hawaii",15003,"Honolulu County",136259,238869,382114,-102610,0.356592535212005,0.625124962707464,-0.26853242749546
"Hawaii",15007,"Kauai County",11582,21225,33497,-9643,0.345762307072275,0.633638833328358,-0.287876526256083
"Hawaii",15009,"Maui County",22126,47305,71044,-25179,0.311440797252407,0.665854963121446,-0.354414165869039
"Idaho",16001,"Ada County",130699,120539,259389,10160,0.503872562059301,0.464703591902509,0.0391689701567915
"Idaho",16003,"Adams County",1941,591,2586,1350,0.750580046403712,0.228538283062645,0.522041763341067
"Idaho",16005,"Bannock County",23331,14682,39553,8649,0.589866761054787,0.371198139205623,0.218668621849164
"Idaho",16007,"Bear Lake County",2914,350,3315,2564,0.879034690799397,0.105580693815988,0.773453996983409
"Idaho",16009,"Benewah County",3878,977,4973,2901,0.779810979288156,0.196460888799517,0.583350090488639
"Idaho",16011,"Bingham County",15295,4124,20094,11171,0.761172489300289,0.205235393649846,0.555937095650443
"Idaho",16013,"Blaine County",4031,8919,13288,-4888,0.30335641180012,0.671207104154124,-0.367850692354004
"Idaho",16015,"Boise County",3485,1204,4820,2281,0.723029045643154,0.249792531120332,0.473236514522822
"Idaho",16017,"Bonner County",18369,8310,27352,10059,0.671577946768061,0.303816905527932,0.367761041240129
"Idaho",16019,"Bonneville County",37805,14254,53995,23551,0.700157421983517,0.263987406241319,0.436170015742198
"Idaho",16021,"Boundary County",4937,1220,6313,3717,0.78203706637098,0.193252019642009,0.588785046728972
"Idaho",16023,"Butte County",1202,188,1415,1014,0.849469964664311,0.132862190812721,0.71660777385159
"Idaho",16025,"Camas County",507,149,754,358,0.672413793103448,0.197612732095491,0.474801061007958
"Idaho",16027,"Canyon County",61759,25881,90438,35878,0.682887724186736,0.286173953426657,0.396713770760079
"Idaho",16029,"Caribou County",2906,431,3416,2475,0.850702576112412,0.126170960187354,0.724531615925059
"Idaho",16031,"Cassia County",7907,1464,9629,6443,0.821165230034271,0.152040710354139,0.669124519680133
"Idaho",16033,"Clark County",264,41,311,223,0.84887459807074,0.131832797427653,0.717041800643087
"Idaho",16035,"Clearwater County",3453,877,4419,2576,0.781398506449423,0.198461190314551,0.582937316134872
"Idaho",16037,"Custer County",2089,603,2739,1486,0.762687112084702,0.220153340635268,0.542533771449434
"Idaho",16039,"Elmore County",7246,2601,10205,4645,0.710044096031357,0.254875061244488,0.455169034786869
"Idaho",16041,"Franklin County",5845,657,6664,5188,0.877100840336134,0.0985894357743097,0.778511404561825
"Idaho",16043,"Fremont County",5548,998,6719,4550,0.825718112814407,0.14853400803691,0.677184104777497
"Idaho",16045,"Gem County",7951,1803,9958,6148,0.798453504719823,0.181060453906407,0.617393050813416
"Idaho",16047,"Gooding County",4659,1256,6050,3403,0.770082644628099,0.207603305785124,0.562479338842975
"Idaho",16049,"Idaho County",7826,1561,9602,6265,0.815038533638825,0.162570297854614,0.652468235784212
"Idaho",16051,"Jefferson County",12099,1661,14173,10438,0.853665420165103,0.117194665914062,0.736470754251041
"Idaho",16053,"Jerome County",5734,1893,7812,3841,0.73399897593446,0.242319508448541,0.491679467485919
"Idaho",16055,"Kootenai County",62837,24312,89878,38525,0.699136607401144,0.270500011126193,0.428636596274951
"Idaho",16057,"Latah County",9472,10236,20570,-764,0.460476421973748,0.497617890131259,-0.037141468157511
"Idaho",16059,"Lemhi County",3592,1032,4738,2560,0.758125791473195,0.217813423385395,0.540312368087801
"Idaho",16061,"Lewis County",1489,349,1870,1140,0.796256684491979,0.186631016042781,0.609625668449198
"Idaho",16063,"Lincoln County",1469,414,1940,1055,0.757216494845361,0.21340206185567,0.543814432989691
"Idaho",16065,"Madison County",13559,2666,17112,10893,0.792367928938756,0.155797101449275,0.636570827489481
"Idaho",16067,"Minidoka County",6265,1550,7993,4715,0.78381083448017,0.193919679719755,0.589891154760415
"Idaho",16069,"Nez Perce County",13738,6686,20967,7052,0.655220107788429,0.318882052749559,0.336338055038871
"Idaho",16071,"Oneida County",2148,249,2451,1899,0.876376988984088,0.101591187270502,0.774785801713586
"Idaho",16073,"Owyhee County",3819,816,4742,3003,0.805356389708984,0.172079291438212,0.633277098270772
"Idaho",16075,"Payette County",8862,2161,11293,6701,0.784733905959444,0.191357478083769,0.593376427875675
"Idaho",16077,"Power County",2116,865,3086,1251,0.685677252106286,0.280298120544394,0.405379131561892
"Idaho",16079,"Shoshone County",4216,1693,6049,2523,0.696974706563068,0.279880972061498,0.41709373450157
"Idaho",16081,"Teton County",2858,3318,6347,-460,0.45029147628801,0.522766661414842,-0.0724751851268315
"Idaho",16083,"Twin Falls County",25897,9391,36680,16506,0.706025081788441,0.256025081788441,0.45
"Idaho",16085,"Valley County",3947,2976,7063,971,0.558827693614611,0.421350700835339,0.137476992779272
"Idaho",16087,"Washington County",4154,1073,5344,3081,0.777320359281437,0.200785928143713,0.576534431137725
"Illinois",17001,"Adams County",24220,8633,33527,15587,0.72240283950249,0.257493960091866,0.464908879410624
"Illinois",17003,"Alexander County",1486,1114,2625,372,0.566095238095238,0.424380952380952,0.141714285714286
"Illinois",17005,"Bond County",5625,2288,8144,3337,0.69069253438114,0.280943025540275,0.409749508840864
"Illinois",17007,"Boone County",13883,10542,24979,3341,0.555786860963209,0.42203450898755,0.13375235197566
"Illinois",17009,"Brown County",1931,486,2525,1445,0.764752475247525,0.192475247524752,0.572277227722772
"Illinois",17011,"Bureau County",10411,6669,17434,3742,0.597166456349662,0.382528392795687,0.214638063553975
"Illinois",17013,"Calhoun County",2046,677,2773,1369,0.737829065993509,0.244139920663541,0.493689145329968
"Illinois",17015,"Carroll County",5105,2748,8024,2357,0.636216350947159,0.34247258225324,0.293743768693918
"Illinois",17017,"Cass County",3625,1615,5326,2010,0.680623357116034,0.303229440480661,0.377393916635374
"Illinois",17019,"Champaign County",35285,57067,95568,-21782,0.369213544282605,0.597135024275908,-0.227921479993303
"Illinois",17021,"Christian County",11563,4335,16204,7228,0.713589237225376,0.267526536657615,0.446062700567761
"Illinois",17023,"Clark County",6226,1993,8355,4233,0.745182525433872,0.238539796529025,0.506642728904847
"Illinois",17025,"Clay County",5629,1129,6899,4500,0.815915350050732,0.163646905348601,0.652268444702131
"Illinois",17027,"Clinton County",14304,4493,19214,9811,0.744457166649318,0.233839908400125,0.510617258249193
"Illinois",17029,"Coles County",14037,8067,22606,5970,0.620941343006282,0.356852163142529,0.264089179863753
"Illinois",17031,"Cook County",558269,1725973,2321399,-1167704,0.240488171141626,0.743505532655093,-0.503017361513467
"Illinois",17033,"Crawford County",7043,2202,9441,4841,0.746001482893761,0.233238004448681,0.51276347844508
"Illinois",17035,"Cumberland County",4601,1142,5850,3459,0.786495726495727,0.195213675213675,0.591282051282051
"Illinois",17037,"DeKalb County",21905,24643,47989,-2738,0.456458771801871,0.513513513513513,-0.0570547417116422
"Illinois",17039,"De Witt County",5632,2191,8024,3441,0.701894317048853,0.273055832502493,0.428838484546361
"Illinois",17041,"Douglas County",6227,2335,8760,3892,0.710844748858448,0.266552511415525,0.444292237442922
"Illinois",17043,"DuPage County",193611,281222,485064,-87611,0.399145267428628,0.579762670492966,-0.180617403064338
"Illinois",17045,"Edgar County",6193,1887,8196,4306,0.755612493899463,0.230234260614934,0.525378233284529
"Illinois",17047,"Edwards County",2833,488,3368,2345,0.841152019002375,0.144893111638955,0.69625890736342
"Illinois",17049,"Effingham County",15006,3716,19083,11290,0.786354346800818,0.194728292197244,0.591626054603574
"Illinois",17051,"Fayette County",8055,1826,10076,6229,0.799424374751886,0.181222707423581,0.618201667328305
"Illinois",17053,"Ford County",5048,1754,6967,3294,0.724558633558203,0.251758289077078,0.472800344481125
"Illinois",17055,"Franklin County",13622,4760,18669,8862,0.729658792650919,0.254968128983877,0.474690663667042
"Illinois",17057,"Fulton County",9867,6503,16724,3364,0.589990432910787,0.388842382205214,0.201148050705573
"Illinois",17059,"Gallatin County",2019,622,2675,1397,0.754766355140187,0.232523364485981,0.522242990654206
"Illinois",17061,"Greene County",4770,1349,6227,3421,0.766018949735025,0.216637224987956,0.549381724747069
"Illinois",17063,"Grundy County",16523,9626,26753,6897,0.617612977983778,0.359810114753486,0.257802863230292
"Illinois",17065,"Hamilton County",3432,824,4323,2608,0.793893129770992,0.190608373814481,0.603284755956512
"Illinois",17067,"Hancock County",6906,2315,9383,4591,0.73601193648087,0.246722796546947,0.489289139933923
"Illinois",17069,"Hardin County",1691,449,2162,1242,0.782146160962072,0.207678075855689,0.574468085106383
"Illinois",17071,"Henderson County",2394,1187,3656,1207,0.654814004376368,0.324671772428884,0.330142231947484
"Illinois",17073,"Henry County",15300,9797,25700,5503,0.595330739299611,0.381206225680934,0.214124513618677
"Illinois",17075,"Iroquois County",10877,2908,14044,7969,0.774494446026773,0.207063514668186,0.567430931358587
"Illinois",17077,"Jackson County",10890,11181,22716,-291,0.479397781299524,0.492208135235077,-0.0128103539355521
"Illinois",17079,"Jasper County",4494,1007,5586,3487,0.804511278195489,0.180272108843537,0.624239169351951
"Illinois",17081,"Jefferson County",12476,4608,17436,7868,0.715531085111264,0.264280798348245,0.451250286763019
"Illinois",17083,"Jersey County",8712,2961,11960,5751,0.728428093645485,0.24757525083612,0.480852842809365
"Illinois",17085,"Jo Daviess County",7166,5109,12495,2057,0.573509403761505,0.408883553421369,0.164625850340136
"Illinois",17087,"Johnson County",5059,1281,6450,3778,0.784341085271318,0.198604651162791,0.585736434108527
"Illinois",17089,"Kane County",96775,130166,231876,-33391,0.417356690645,0.561360382273284,-0.144003691628284
"Illinois",17091,"Kankakee County",28532,20271,50039,8261,0.570195247706789,0.405104018865285,0.165091228841504
"Illinois",17093,"Kendall County",29492,33168,64205,-3676,0.459341172805856,0.516595280741375,-0.057254107935519
"Illinois",17095,"Knox County",12009,10703,23205,1306,0.517517776341306,0.461236802413273,0.0562809739280328
"Illinois",17097,"Lake County",123594,204032,334156,-80438,0.369869162905948,0.610589066184656,-0.240719903278708
"Illinois",17099,"LaSalle County",30113,22442,53683,7671,0.560941080043962,0.418046681444778,0.142894398599184
"Illinois",17101,"Lawrence County",4886,1419,6422,3467,0.760822173777639,0.220959202740579,0.53986297103706
"Illinois",17103,"Lee County",9630,6407,16440,3223,0.585766423357664,0.389720194647202,0.196046228710462
"Illinois",17105,"Livingston County",12208,4615,17174,7593,0.710841970420403,0.268720158378945,0.442121812041458
"Illinois",17107,"Logan County",9136,3840,13294,5296,0.687227320595758,0.28885211373552,0.398375206860238
"Illinois",17109,"McDonough County",7027,4992,12285,2035,0.571998371998372,0.406349206349206,0.165649165649166
"Illinois",17111,"McHenry County",82260,78154,164578,4106,0.499823791758315,0.474875135194254,0.0249486565640608
"Illinois",17113,"McLean County",40502,43933,87389,-3431,0.46346794218952,0.502729176440971,-0.0392612342514504
"Illinois",17115,"Macon County",28589,19847,49387,8742,0.578877032417438,0.401866888047462,0.177010144369976
"Illinois",17117,"Macoupin County",16153,7365,24070,8788,0.671084337349398,0.305982550893228,0.36510178645617
"Illinois",17119,"Madison County",76031,57836,137558,18195,0.552719580104392,0.420448101891566,0.132271478212827
"Illinois",17121,"Marion County",12678,4524,17492,8154,0.724788474731306,0.258632517722387,0.466155957008918
"Illinois",17123,"Marshall County",4197,2005,6345,2192,0.661465721040189,0.315996847911742,0.345468873128448
"Illinois",17125,"Mason County",4654,1985,6766,2669,0.687851019804907,0.293378657995862,0.394472361809045
"Illinois",17127,"Massac County",4997,1725,6818,3272,0.732912877676738,0.253006746846583,0.479906130830155
"Illinois",17129,"Menard County",4764,2022,6954,2742,0.685073339085418,0.29076790336497,0.394305435720449
"Illinois",17131,"Mercer County",5418,3280,8914,2138,0.607807942562262,0.367960511554858,0.239847431007404
"Illinois",17133,"Monroe County",14142,6569,21206,7573,0.666886730170706,0.309770819579364,0.357115910591342
"Illinois",17135,"Montgomery County",9544,3905,13761,5639,0.693554247511082,0.283772981614708,0.409781265896374
"Illinois",17137,"Morgan County",9950,5076,15333,4874,0.64892715059023,0.331050675014674,0.317876475575556
"Illinois",17139,"Moultrie County",4964,1662,6744,3302,0.736061684460261,0.24644128113879,0.489620403321471
"Illinois",17141,"Ogle County",16248,9428,26340,6820,0.616856492027335,0.35793470007593,0.258921791951405
"Illinois",17143,"Peoria County",38252,43578,83973,-5326,0.455527371893347,0.518952520453003,-0.0634251485596561
"Illinois",17145,"Perry County",7313,2612,10071,4701,0.726144374937941,0.25935855426472,0.46678582067322
"Illinois",17147,"Piatt County",6248,3329,9851,2919,0.634250329915745,0.337935235001523,0.296315094914222
"Illinois",17149,"Pike County",6332,1484,7965,4848,0.794978028876334,0.18631512868801,0.608662900188324
"Illinois",17151,"Pope County",1722,433,2175,1289,0.791724137931034,0.199080459770115,0.59264367816092
"Illinois",17153,"Pulaski County",1699,891,2631,808,0.645762067654884,0.338654503990878,0.307107563664006
"Illinois",17155,"Putnam County",1993,1338,3390,655,0.587905604719764,0.394690265486726,0.193215339233038
"Illinois",17157,"Randolph County",11076,3592,14910,7484,0.742857142857143,0.240912139503689,0.501945003353454
"Illinois",17159,"Richland County",6089,1830,8063,4259,0.75517797345901,0.226962668981769,0.528215304477242
"Illinois",17161,"Rock Island County",28603,36691,66817,-8088,0.428079680320876,0.549126719248096,-0.121047038927219
"Illinois",17163,"St. Clair County",57150,68325,128104,-11175,0.446121900955474,0.533355710984825,-0.0872338100293512
"Illinois",17165,"Saline County",8103,2789,11089,5314,0.730724141040671,0.251510505906754,0.479213635133917
"Illinois",17167,"Sangamon County",53485,48917,104751,4568,0.510591784326641,0.466983608748365,0.0436081755782761
"Illinois",17169,"Schuyler County",2773,1068,3918,1705,0.707759060745278,0.272588055130168,0.43517100561511
"Illinois",17171,"Scott County",2114,572,2741,1542,0.771251368113827,0.208682962422474,0.562568405691354
"Illinois",17173,"Shelby County",9426,2504,12097,6922,0.779201454906175,0.206993469455237,0.572207985450938
"Illinois",17175,"Stark County",2004,815,2886,1189,0.694386694386694,0.282397782397782,0.411988911988912
"Illinois",17177,"Stephenson County",12521,9055,22048,3466,0.567897314949202,0.410694847605225,0.157202467343977
"Illinois",17179,"Tazewell County",42513,24819,69051,17694,0.615675370378416,0.359429986531694,0.256245383846722
"Illinois",17181,"Union County",6161,2579,8904,3582,0.691936208445642,0.289645103324349,0.402291105121294
"Illinois",17183,"Vermilion County",20725,10323,31642,10402,0.65498388218191,0.326243600278111,0.328740281903799
"Illinois",17185,"Wabash County",4237,1253,5607,2984,0.755662564651329,0.223470661672909,0.53219190297842
"Illinois",17187,"Warren County",4676,3090,7924,1586,0.590106007067138,0.389954568399798,0.20015143866734
"Illinois",17189,"Washington County",6115,1641,7921,4474,0.771998485039768,0.207170811766191,0.564827673273577
"Illinois",17191,"Wayne County",7176,1187,8499,5989,0.844334627603247,0.139663489822332,0.704671137780915
"Illinois",17193,"White County",5791,1517,7431,4274,0.779302920199166,0.204144798815772,0.575158121383394
"Illinois",17195,"Whiteside County",14527,12253,27375,2274,0.530666666666667,0.447598173515982,0.0830684931506849
"Illinois",17197,"Will County",155116,183915,346266,-28799,0.447967747338751,0.531137911316733,-0.0831701639779823
"Illinois",17199,"Williamson County",22801,10206,33729,12595,0.676005811023155,0.302588277150227,0.373417533872928
"Illinois",17201,"Winnebago County",60861,64056,127710,-3195,0.47655626027719,0.501573878318064,-0.0250176180408738
"Illinois",17203,"Woodford County",14799,6160,21498,8639,0.68838961763885,0.286538282630942,0.401851335007908
"Indiana",18001,"Adams County",10686,3236,14209,7450,0.752058554437328,0.227742979801534,0.524315574635794
"Indiana",18003,"Allen County",92083,73189,169082,18894,0.544605575992714,0.432860978696727,0.111744597295987
"Indiana",18005,"Bartholomew County",22410,12934,36235,9476,0.618462812198151,0.356947702497585,0.261515109700566
"Indiana",18007,"Benton County",3007,1009,4114,1998,0.730918813806514,0.245260087506077,0.485658726300438
"Indiana",18009,"Blackford County",3841,1376,5350,2465,0.717943925233645,0.257196261682243,0.460747663551402
"Indiana",18011,"Boone County",22351,15244,38520,7107,0.580244029075805,0.395742471443406,0.184501557632399
"Indiana",18013,"Brown County",5777,3036,8981,2741,0.643246854470549,0.338046988085959,0.30519986638459
"Indiana",18015,"Carroll County",7086,2224,9495,4862,0.746287519747235,0.234228541337546,0.512058978409689
"Indiana",18017,"Cass County",10552,4304,15198,6248,0.694301881826556,0.283195157257534,0.411106724569022
"Indiana",18019,"Clark County",33668,23093,57869,10575,0.581796816948625,0.399056489657675,0.18274032729095
"Indiana",18021,"Clay County",9499,2552,12267,6947,0.774353957772887,0.208037825059102,0.566316132713785
"Indiana",18023,"Clinton County",9334,3361,12949,5973,0.720827863155456,0.259556722526836,0.46127114062862
"Indiana",18025,"Crawford County",3483,1355,4944,2128,0.704490291262136,0.274069579288026,0.43042071197411
"Indiana",18027,"Daviess County",9576,2169,11954,7407,0.801070771289945,0.181445541241425,0.619625230048519
"Indiana",18029,"Dearborn County",19528,5446,25383,14082,0.769333806090691,0.214553047315132,0.554780758775558
"Indiana",18031,"Decatur County",9575,2439,12287,7136,0.77927891267193,0.198502482298364,0.580776430373566
"Indiana",18033,"DeKalb County",14237,4966,19628,9271,0.725341349093132,0.253005909924598,0.472335439168535
"Indiana",18035,"Delaware County",26827,20474,48191,6353,0.55668070801602,0.424851113278413,0.131829594737607
"Indiana",18037,"Dubois County",15033,6292,21770,8741,0.690537436839688,0.289021589343133,0.401515847496555
"Indiana",18039,"Elkhart County",46972,26108,74387,20864,0.631454420799333,0.350975304824768,0.280479115974565
"Indiana",18041,"Fayette County",7755,2237,10136,5518,0.765094711917916,0.220698500394633,0.544396211523283
"Indiana",18043,"Floyd County",23400,17511,41802,5889,0.55978182862064,0.418903401751112,0.140878426869528
"Indiana",18045,"Fountain County",6154,1629,7986,4525,0.770598547458052,0.203981968444778,0.566616579013273
"Indiana",18047,"Franklin County",9691,2137,12000,7554,0.807583333333333,0.178083333333333,0.6295
"Indiana",18049,"Fulton County",6694,2280,9147,4414,0.731824641959112,0.249262053132174,0.482562588826938
"Indiana",18051,"Gibson County",11817,4023,16161,7794,0.731204752181177,0.248932615555968,0.482272136625209
"Indiana",18053,"Grant County",18543,8015,27159,10528,0.682757097094886,0.295113958540447,0.387643138554439
"Indiana",18055,"Greene County",11103,3389,14784,7714,0.75101461038961,0.229234307359307,0.521780303030303
"Indiana",18057,"Hamilton County",101587,88390,193999,13197,0.523647029108397,0.455620905262398,0.0680261238459992
"Indiana",18059,"Hancock County",28996,12895,42911,16101,0.6757241732889,0.300505697839715,0.375218475449186
"Indiana",18061,"Harrison County",14565,5343,20236,9222,0.719756868946432,0.264034394149041,0.455722474797391
"Indiana",18063,"Hendricks County",53802,32604,88505,21198,0.60789785887803,0.368385966894526,0.239511891983504
"Indiana",18065,"Henry County",15043,5544,21030,9499,0.715311459819306,0.263623395149786,0.45168806466952
"Indiana",18067,"Howard County",26449,13303,40630,13146,0.650972188038395,0.327418163918287,0.323554024120108
"Indiana",18069,"Huntington County",13147,4255,17829,8892,0.73739413315385,0.238656122048348,0.498738011105502
"Indiana",18071,"Jackson County",14555,4302,19238,10253,0.756575527601622,0.22361991891049,0.532955608691132
"Indiana",18073,"Jasper County",11383,3798,15475,7585,0.735573505654281,0.245428109854604,0.490145395799677
"Indiana",18075,"Jay County",6361,1926,8461,4435,0.751802387424654,0.227632667533388,0.524169719891266
"Indiana",18077,"Jefferson County",9663,4731,14697,4932,0.657481118595632,0.321902429067156,0.335578689528475
"Indiana",18079,"Jennings County",9490,2523,12251,6967,0.774630642396539,0.205942372051261,0.568688270345278
"Indiana",18081,"Johnson County",51219,24736,77618,26483,0.659885593547888,0.318688963900126,0.341196629647762
"Indiana",18083,"Knox County",11655,4067,16011,7588,0.727937043282743,0.254012866154519,0.473924177128224
"Indiana",18085,"Kosciusko County",26499,8364,35787,18135,0.740464414452175,0.233716153910638,0.506748260541537
"Indiana",18087,"LaGrange County",8110,2355,10633,5755,0.76271983447757,0.221480297188,0.54123953728957
"Indiana",18089,"Lake County",91760,124870,219956,-33110,0.417174343959701,0.567704449980905,-0.150530106021204
"Indiana",18091,"LaPorte County",25997,22427,49392,3570,0.526340298023972,0.454061386459346,0.0722789115646259
"Indiana",18093,"Lawrence County",15601,4961,21025,10640,0.742021403091558,0.235957193816885,0.506064209274673
"Indiana",18095,"Madison County",31215,19524,51793,11691,0.602687621879405,0.376962137740621,0.225725484138783
"Indiana",18097,"Marion County",134175,247772,389619,-113597,0.344374889314946,0.635934079190183,-0.291559189875237
"Indiana",18099,"Marshall County",13844,5712,19927,8132,0.694735785617504,0.286646258844783,0.40808952677272
"Indiana",18101,"Martin County",4029,1011,5144,3018,0.783242612752722,0.19653965785381,0.586702954898911
"Indiana",18103,"Miami County",10925,3235,14473,7690,0.754853865819111,0.22351965729289,0.531334208526221
"Indiana",18105,"Monroe County",22071,39861,63151,-17790,0.349495653275483,0.631201406153505,-0.281705752878022
"Indiana",18107,"Montgomery County",12659,4213,17198,8446,0.736073962088615,0.244970345388999,0.491103616699616
"Indiana",18109,"Morgan County",27512,7781,36159,19731,0.760861749495285,0.215188473132553,0.545673276362731
"Indiana",18111,"Newton County",4942,1509,6591,3433,0.749810347443484,0.228948566226673,0.520861781216811
"Indiana",18113,"Noble County",14195,4660,19190,9535,0.73970818134445,0.242834809796769,0.496873371547681
"Indiana",18115,"Ohio County",2392,750,3164,1642,0.756005056890013,0.237041719342604,0.518963337547408
"Indiana",18117,"Orange County",6432,2224,8832,4208,0.728260869565217,0.251811594202899,0.476449275362319
"Indiana",18119,"Owen County",7286,2420,9904,4866,0.735662358642973,0.244345718901454,0.491316639741519
"Indiana",18121,"Parke County",5398,1503,7011,3895,0.76993296248752,0.214377406931964,0.555555555555556
"Indiana",18123,"Perry County",5345,3203,8722,2142,0.612818160972254,0.367232286172896,0.245585874799358
"Indiana",18125,"Pike County",4692,1415,6220,3277,0.754340836012862,0.227491961414791,0.526848874598071
"Indiana",18127,"Porter County",45008,39746,86509,5262,0.520269567328255,0.45944352610711,0.0608260412211447
"Indiana",18129,"Posey County",9206,3811,13236,5395,0.695527349652463,0.287926866122696,0.407600483529767
"Indiana",18131,"Pulaski County",4246,1463,5806,2783,0.731312435411643,0.251980709610747,0.479331725800896
"Indiana",18133,"Putnam County",12278,3946,16597,8332,0.739772247996626,0.237753810929686,0.50201843706694
"Indiana",18135,"Randolph County",8312,2513,11070,5799,0.750858175248419,0.227009936766034,0.523848238482385
"Indiana",18137,"Ripley County",11261,2774,14271,8487,0.789082755237895,0.194380211617967,0.594702543619929
"Indiana",18139,"Rush County",6035,1754,7932,4281,0.76084215834594,0.221129601613717,0.539712556732224
"Indiana",18141,"St. Joseph County",53164,59896,115238,-6732,0.461340877141221,0.519759107238932,-0.0584182300977108
"Indiana",18143,"Scott County",7328,2698,10161,4630,0.721188859364236,0.265525046747367,0.455663812616869
"Indiana",18145,"Shelby County",14568,5023,19991,9545,0.728727927567405,0.251263068380771,0.477464859186634
"Indiana",18147,"Spencer County",7357,3213,10769,4144,0.68316463924227,0.298356393351286,0.384808245890983
"Indiana",18149,"Starke County",7466,2650,10290,4816,0.72555879494655,0.257531584062196,0.468027210884354
"Indiana",18151,"Steuben County",11327,4513,16162,6814,0.70084148001485,0.279235243162975,0.421606236851875
"Indiana",18153,"Sullivan County",6691,2153,8994,4538,0.743940404714254,0.239381810095619,0.504558594618635
"Indiana",18155,"Switzerland County",3133,964,4154,2169,0.754212806933077,0.232065479056331,0.522147327876745
"Indiana",18157,"Tippecanoe County",34581,35017,71448,-436,0.48400235136043,0.490104691523906,-0.00610234016347555
"Indiana",18159,"Tipton County",6110,1834,8116,4276,0.752833908329226,0.225973385904386,0.52686052242484
"Indiana",18161,"Union County",2688,736,3483,1952,0.771748492678725,0.21131208728108,0.560436405397646
"Indiana",18163,"Vanderburgh County",41844,34415,77662,7429,0.538796322525817,0.443138214313306,0.0956581082125106
"Indiana",18165,"Vermillion County",5184,2145,7481,3039,0.692955487234327,0.286726373479481,0.406229113754846
"Indiana",18167,"Vigo County",24545,18123,43594,6422,0.563036197641877,0.415722347111988,0.147313850529889
"Indiana",18169,"Wabash County",10762,3494,14573,7268,0.73848898648185,0.239758457421258,0.498730529060592
"Indiana",18171,"Warren County",3401,974,4472,2427,0.760509838998211,0.217799642218247,0.542710196779964
"Indiana",18173,"Warrick County",21326,11923,33829,9403,0.630405864790564,0.352449082148452,0.277956782642112
"Indiana",18175,"Washington County",9114,2784,12139,6330,0.750803196309416,0.229343438503995,0.521459757805421
"Indiana",18177,"Wayne County",17567,9524,27679,8043,0.634668882546335,0.344087575418187,0.290581307128148
"Indiana",18179,"Wells County",10855,2928,14050,7927,0.772597864768683,0.208398576512456,0.564199288256228
"Indiana",18181,"White County",7957,3032,11166,4925,0.712609708042271,0.271538599319362,0.441071108722909
"Indiana",18183,"Whitley County",12862,4234,17556,8628,0.732627022100706,0.241171109592162,0.491455912508544
"Iowa",19001,"Adair County",2917,1198,4177,1719,0.698348096720134,0.286808714388317,0.411539382331817
"Iowa",19003,"Adams County",1530,590,2160,940,0.708333333333333,0.273148148148148,0.435185185185185
"Iowa",19005,"Allamakee County",4735,2576,7422,2159,0.637968202640798,0.347076259768257,0.290891942872541
"Iowa",19007,"Appanoose County",4512,1891,6516,2621,0.692449355432781,0.290208717004297,0.402240638428484
"Iowa",19009,"Audubon County",2295,1071,3420,1224,0.671052631578947,0.313157894736842,0.357894736842105
"Iowa",19011,"Benton County",9188,5160,14642,4028,0.627509903018713,0.35241087283158,0.275099030187133
"Iowa",19013,"Black Hawk County",29640,35647,66593,-6007,0.445091826468247,0.535296502635412,-0.0902046761671648
"Iowa",19015,"Boone County",8695,6303,15340,2392,0.566818774445893,0.410886571056063,0.155932203389831
"Iowa",19017,"Bremer County",8294,5958,14546,2336,0.570191117833081,0.409597140107246,0.160593977725835
"Iowa",19019,"Buchanan County",6420,4169,10774,2251,0.595878967885651,0.386950064971227,0.208928902914424
"Iowa",19021,"Buena Vista County",5056,2961,8167,2095,0.619076772376638,0.362556630341619,0.256520142035019
"Iowa",19023,"Butler County",5542,2424,8098,3118,0.684366510249444,0.299333168683626,0.385033341565819
"Iowa",19025,"Calhoun County",3689,1470,5258,2219,0.701597565614302,0.279573982502853,0.422023583111449
"Iowa",19027,"Carroll County",7737,3454,11335,4283,0.682576091751213,0.304719894133216,0.377856197617997
"Iowa",19029,"Cass County",4969,2201,7276,2768,0.682930181418362,0.302501374381528,0.380428807036833
"Iowa",19031,"Cedar County",6161,4337,10703,1824,0.575633000093432,0.405213491544427,0.170419508549005
"Iowa",19033,"Cerro Gordo County",12442,10941,23801,1501,0.522751144909878,0.459686567791269,0.0630645771186085
"Iowa",19035,"Cherokee County",4495,1936,6518,2559,0.689628720466401,0.297023626879411,0.39260509358699
"Iowa",19037,"Chickasaw County",4308,2233,6631,2075,0.649675765344594,0.336751621173277,0.312924144171317
"Iowa",19039,"Clarke County",3144,1466,4670,1678,0.673233404710921,0.313918629550321,0.3593147751606
"Iowa",19041,"Clay County",6137,2662,8969,3475,0.684245735310514,0.29680008919612,0.387445646114394
"Iowa",19043,"Clayton County",6106,3340,9594,2766,0.63643944131749,0.348134250573275,0.288305190744215
"Iowa",19045,"Clinton County",13361,10812,24687,2549,0.541216024628347,0.437963300522542,0.103252724105805
"Iowa",19047,"Crawford County",4854,2220,7154,2634,0.678501537601342,0.310315907184792,0.36818563041655
"Iowa",19049,"Dallas County",27987,26879,56022,1108,0.499571596872657,0.479793652493663,0.019777944378994
"Iowa",19051,"Davis County",3032,1013,4102,2019,0.739151633349586,0.246952705997075,0.492198927352511
"Iowa",19053,"Decatur County",2615,1120,3804,1495,0.687434279705573,0.294426919032597,0.393007360672976
"Iowa",19055,"Delaware County",6666,3157,10003,3509,0.666400079976007,0.315605318404479,0.350794761571529
"Iowa",19057,"Des Moines County",10592,8893,19956,1699,0.530767688915614,0.445630386851072,0.085137302064542
"Iowa",19059,"Dickinson County",7438,3661,11244,3777,0.66150836001423,0.325595873354678,0.335912486659552
"Iowa",19061,"Dubuque County",27214,25657,53926,1557,0.504654526573453,0.47578162667359,0.0288728998998628
"Iowa",19063,"Emmet County",3265,1520,4853,1745,0.672779723882135,0.313208324747579,0.359571399134556
"Iowa",19065,"Fayette County",6145,3835,10186,2310,0.60327901040644,0.376497152955036,0.226781857451404
"Iowa",19067,"Floyd County",4732,3172,8032,1560,0.589143426294821,0.3949203187251,0.194223107569721
"Iowa",19069,"Franklin County",3422,1626,5130,1796,0.667056530214425,0.316959064327485,0.35009746588694
"Iowa",19071,"Fremont County",2711,1080,3857,1631,0.702877884366088,0.280010370754472,0.422867513611615
"Iowa",19073,"Greene County",3223,1769,5057,1454,0.637334387977062,0.34981214158592,0.287522246391141
"Iowa",19075,"Grundy County",4929,2206,7276,2723,0.677432655305113,0.303188565145684,0.374244090159428
"Iowa",19077,"Guthrie County",4272,1985,6371,2287,0.670538377020876,0.311568042693455,0.358970334327421
"Iowa",19079,"Hamilton County",4956,2843,7943,2113,0.623945612488984,0.357925217172353,0.266020395316631
"Iowa",19081,"Hancock County",4390,1683,6172,2707,0.711276733635774,0.272683084899546,0.438593648736228
"Iowa",19083,"Hardin County",5850,2976,8989,2874,0.650795416620314,0.331071309378129,0.319724107242185
"Iowa",19085,"Harrison County",5569,2440,8155,3129,0.68289393010423,0.299202942979767,0.383690987124463
"Iowa",19087,"Henry County",6507,3275,9982,3232,0.651873372069726,0.328090563013424,0.323782809056301
"Iowa",19089,"Howard County",3127,1772,4958,1355,0.630697862041146,0.357402178297701,0.273295683743445
"Iowa",19091,"Humboldt County",3819,1442,5327,2377,0.716913835179275,0.270696452036794,0.446217383142482
"Iowa",19093,"Ida County",2880,917,3849,1963,0.748246297739673,0.23824369966225,0.510002598077423
"Iowa",19095,"Iowa County",6009,3547,9742,2462,0.616813795935126,0.364093615274071,0.252720180661055
"Iowa",19097,"Jackson County",6940,4029,11135,2911,0.623259991019309,0.361832061068702,0.261427929950606
"Iowa",19099,"Jasper County",12084,7737,20184,4347,0.598692033293698,0.383323424494649,0.215368608799049
"Iowa",19101,"Jefferson County",4443,4319,8959,124,0.495925884585333,0.482085054135506,0.013840830449827
"Iowa",19103,"Johnson County",22925,59177,83851,-36252,0.273401629080154,0.705739943471157,-0.432338314391003
"Iowa",19105,"Jones County",6572,4213,10989,2359,0.598052598052598,0.383383383383383,0.214669214669215
"Iowa",19107,"Keokuk County",3797,1414,5303,2383,0.716009805770319,0.26664152366585,0.449368282104469
"Iowa",19109,"Kossuth County",6275,2696,9090,3579,0.69031903190319,0.296589658965897,0.393729372937294
"Iowa",19111,"Lee County",9773,6541,16734,3232,0.584020556949922,0.390880841400741,0.193139715549181
"Iowa",19113,"Linn County",53364,70874,127458,-17510,0.418679094289884,0.556057681746144,-0.13737858745626
"Iowa",19115,"Louisa County",3500,1726,5332,1774,0.656414103525881,0.32370592648162,0.332708177044261
"Iowa",19117,"Lucas County",3287,1284,4630,2003,0.709935205183585,0.27732181425486,0.432613390928726
"Iowa",19119,"Lyon County",5707,1067,6863,4640,0.83156054203701,0.155471368206324,0.676089173830686
"Iowa",19121,"Madison County",6507,3134,9824,3373,0.662357491856677,0.319014657980456,0.343342833876221
"Iowa",19123,"Mahaska County",8297,2894,11404,5403,0.727551736232901,0.25377060680463,0.473781129428271
"Iowa",19125,"Marion County",12663,6178,19232,6485,0.658433860232945,0.32123544093178,0.337198419301165
"Iowa",19127,"Marshall County",9571,8176,18136,1395,0.527734891927658,0.450816056462285,0.0769188354653727
"Iowa",19129,"Mills County",5585,2508,8268,3077,0.675495887760039,0.3033381712627,0.372157716497339
"Iowa",19131,"Mitchell County",3677,2053,5822,1624,0.631569907248368,0.352627962899347,0.278941944349021
"Iowa",19133,"Monona County",3248,1407,4728,1841,0.686971235194585,0.29758883248731,0.389382402707276
"Iowa",19135,"Monroe County",2975,1078,4088,1897,0.727739726027397,0.263698630136986,0.464041095890411
"Iowa",19137,"Montgomery County",3659,1583,5327,2076,0.686878167824291,0.297165383893373,0.389712783930918
"Iowa",19139,"Muscatine County",10823,9372,20671,1451,0.5235837646945,0.453388805573025,0.0701949591214745
"Iowa",19141,"O'Brien County",5861,1569,7551,4292,0.776188584293471,0.207787048073103,0.568401536220368
"Iowa",19143,"Osceola County",2690,601,3328,2089,0.808293269230769,0.180588942307692,0.627704326923077
"Iowa",19145,"Page County",5319,2086,7528,3233,0.706562167906483,0.277098831030818,0.429463336875664
"Iowa",19147,"Palo Alto County",3370,1519,4958,1851,0.679709560306575,0.306373537716821,0.373336022589754
"Iowa",19149,"Plymouth County",10492,3494,14188,6998,0.739498167465464,0.246264448829997,0.493233718635467
"Iowa",19151,"Pocahontas County",2826,933,3823,1893,0.739210044467696,0.244049176039759,0.495160868427936
"Iowa",19153,"Polk County",106800,146250,258755,-39450,0.412745647427103,0.565206469440204,-0.152460822013101
"Iowa",19155,"Pottawattamie County",26247,18575,45744,7672,0.573780167890871,0.406064183280867,0.167715984610003
"Iowa",19157,"Poweshiek County",5657,4306,10140,1351,0.557889546351085,0.42465483234714,0.133234714003945
"Iowa",19159,"Ringgold County",1968,709,2714,1259,0.725128960943257,0.261238025055269,0.463890935887988
"Iowa",19161,"Sac County",4061,1389,5535,2672,0.733694670280036,0.250948509485095,0.482746160794941
"Iowa",19163,"Scott County",43683,46926,92599,-3243,0.471743755332131,0.506765731811359,-0.0350219764792276
"Iowa",19165,"Shelby County",4697,1959,6795,2738,0.691243561442237,0.288300220750552,0.402943340691685
"Iowa",19167,"Sioux County",15680,3019,19051,12661,0.823053907931342,0.158469371686526,0.664584536244817
"Iowa",19169,"Story County",20340,29175,51038,-8835,0.398526588032446,0.571632900975744,-0.173106312943297
"Iowa",19171,"Tama County",5303,3577,9048,1726,0.586096374889478,0.395335985853227,0.190760389036251
"Iowa",19173,"Taylor County",2463,746,3249,1717,0.758079409048938,0.229609110495537,0.528470298553401
"Iowa",19175,"Union County",4010,2061,6185,1949,0.648342764753436,0.33322554567502,0.315117219078416
"Iowa",19177,"Van Buren County",2859,875,3791,1984,0.754154576628858,0.230809812714323,0.523344763914534
"Iowa",19179,"Wapello County",9516,5821,15633,3695,0.608712339282288,0.372353355082198,0.23635898420009
"Iowa",19181,"Warren County",17782,12574,31039,5208,0.572892167917781,0.405103257192564,0.167788910725217
"Iowa",19183,"Washington County",6971,4561,11765,2410,0.592520186995325,0.387675308117297,0.204844878878028
"Iowa",19185,"Wayne County",2338,727,3109,1611,0.752010292698617,0.23383724670312,0.518173045995497
"Iowa",19187,"Webster County",10938,6613,17822,4325,0.613735832117607,0.371058242621479,0.242677589496128
"Iowa",19189,"Winnebago County",3707,2135,5970,1572,0.620938023450586,0.357621440536013,0.263316582914573
"Iowa",19191,"Winneshiek County",6235,5617,12064,618,0.516826923076923,0.465600132625995,0.0512267904509284
"Iowa",19193,"Woodbury County",25736,18704,45362,7032,0.567347118733742,0.412327498787531,0.15501961994621
"Iowa",19195,"Worth County",2738,1596,4418,1142,0.61973743775464,0.361249434133092,0.258488003621548
"Iowa",19197,"Wright County",4136,1996,6254,2140,0.66133674448353,0.319155740326191,0.342181004157339
"Kansas",20001,"Allen County",4155,1559,5842,2596,0.711229031153714,0.266860664156111,0.444368366997604
"Kansas",20003,"Anderson County",2874,765,3720,2109,0.77258064516129,0.205645161290323,0.566935483870968
"Kansas",20005,"Atchison County",4826,2314,7312,2512,0.660010940919037,0.316466083150985,0.343544857768053
"Kansas",20007,"Barber County",1992,284,2313,1708,0.861219195849546,0.122784262862084,0.738434932987462
"Kansas",20009,"Barton County",8480,2302,10961,6178,0.773652039047532,0.210017334184837,0.563634704862695
"Kansas",20011,"Bourbon County",4910,1505,6550,3405,0.749618320610687,0.229770992366412,0.519847328244275
"Kansas",20013,"Brown County",3206,1088,4396,2118,0.729299363057325,0.247497725204732,0.481801637852593
"Kansas",20015,"Butler County",22250,9003,31946,13247,0.696487823201653,0.281819320102673,0.41466850309898
"Kansas",20017,"Chase County",1114,341,1478,773,0.753721244925575,0.230717185385656,0.523004059539919
"Kansas",20019,"Chautauqua County",1397,212,1634,1185,0.854957160342717,0.129742962056304,0.725214198286414
"Kansas",20021,"Cherokee County",6622,2163,8945,4459,0.740301844605925,0.241811067635551,0.498490776970374
"Kansas",20023,"Cheyenne County",1158,220,1400,938,0.827142857142857,0.157142857142857,0.67
"Kansas",20025,"Clark County",885,143,1048,742,0.844465648854962,0.136450381679389,0.708015267175573
"Kansas",20027,"Clay County",3129,883,4134,2246,0.75689404934688,0.21359458151911,0.54329946782777
"Kansas",20029,"Cloud County",3182,893,4174,2289,0.76233828461907,0.21394345951126,0.54839482510781
"Kansas",20031,"Coffey County",3407,928,4448,2479,0.765962230215827,0.20863309352518,0.557329136690647
"Kansas",20033,"Comanche County",745,126,904,619,0.824115044247788,0.139380530973451,0.684734513274336
"Kansas",20035,"Cowley County",9442,4171,13911,5271,0.678743440442815,0.29983466321616,0.378908777226655
"Kansas",20037,"Crawford County",10045,6179,16718,3866,0.600849383897595,0.369601626988874,0.231247756908721
"Kansas",20039,"Decatur County",1232,208,1458,1024,0.844993141289438,0.142661179698217,0.702331961591221
"Kansas",20041,"Dickinson County",7045,2040,9246,5005,0.761951113995241,0.220635950681376,0.541315163313865
"Kansas",20043,"Doniphan County",2949,678,3674,2271,0.802667392487752,0.184540010887316,0.618127381600435
"Kansas",20045,"Douglas County",16737,39436,57540,-22699,0.290875912408759,0.685366701425096,-0.394490789016336
"Kansas",20047,"Edwards County",1127,267,1413,860,0.797593772116065,0.18895966029724,0.608634111818825
"Kansas",20049,"Elk County",1130,191,1347,939,0.838901262063846,0.141796585003712,0.697104677060134
"Kansas",20051,"Ellis County",9569,3633,13501,5936,0.708762313902674,0.269091178431227,0.439671135471447
"Kansas",20053,"Ellsworth County",2106,646,2806,1460,0.750534568781183,0.230220955096222,0.520313613684961
"Kansas",20055,"Finney County",7079,4155,11466,2924,0.617390545961975,0.362375719518577,0.255014826443398
"Kansas",20057,"Ford County",5763,2926,8850,2837,0.651186440677966,0.330621468926554,0.320564971751412
"Kansas",20059,"Franklin County",8326,3623,12247,4703,0.679839960806728,0.295827549603985,0.384012411202743
"Kansas",20061,"Geary County",5193,3825,9311,1368,0.557727419181613,0.410804424873805,0.146922994307808
"Kansas",20063,"Gove County",1256,163,1433,1093,0.876482903000698,0.113747383112352,0.762735519888346
"Kansas",20065,"Graham County",1052,222,1302,830,0.807987711213518,0.170506912442396,0.637480798771121
"Kansas",20067,"Grant County",1910,497,2452,1413,0.778955954323002,0.202691680261011,0.57626427406199
"Kansas",20069,"Gray County",1871,337,2240,1534,0.835267857142857,0.150446428571429,0.684821428571429
"Kansas",20071,"Greeley County",537,77,629,460,0.853736089030207,0.12241653418124,0.731319554848967
"Kansas",20073,"Greenwood County",2404,562,3030,1842,0.793399339933993,0.185478547854785,0.607920792079208
"Kansas",20075,"Hamilton County",684,134,837,550,0.817204301075269,0.160095579450418,0.657108721624851
"Kansas",20077,"Harper County",2128,453,2626,1675,0.81035795887281,0.172505712109672,0.637852246763138
"Kansas",20079,"Harvey County",10015,6652,17034,3363,0.58794176353176,0.390513091464131,0.197428672067629
"Kansas",20081,"Haskell County",1103,261,1383,842,0.797541576283442,0.188720173535792,0.60882140274765
"Kansas",20083,"Hodgeman County",866,151,1033,715,0.838334946757018,0.146176185866409,0.69215876089061
"Kansas",20085,"Jackson County",4435,1852,6468,2583,0.685683364254793,0.286332714904143,0.399350649350649
"Kansas",20087,"Jefferson County",6193,3106,9581,3087,0.64638346727899,0.32418327940716,0.32220018787183
"Kansas",20089,"Jewell County",1369,211,1608,1158,0.85136815920398,0.131218905472637,0.720149253731343
"Kansas",20091,"Johnson County",155631,184259,349386,-28628,0.445441431539901,0.527379459966913,-0.081938028427012
"Kansas",20093,"Kearny County",1134,255,1413,879,0.802547770700637,0.180467091295117,0.62208067940552
"Kansas",20095,"Kingman County",3102,745,3929,2357,0.789513871214049,0.189615678289641,0.599898192924408
"Kansas",20097,"Kiowa County",957,153,1139,804,0.840210711150132,0.134328358208955,0.705882352941176
"Kansas",20099,"Labette County",5639,2607,8414,3032,0.670192536249109,0.309840741621108,0.360351794628001
"Kansas",20101,"Lane County",757,114,888,643,0.852477477477477,0.128378378378378,0.724099099099099
"Kansas",20103,"Leavenworth County",21378,13753,36115,7625,0.591942406202409,0.380811297244912,0.211131108957497
"Kansas",20105,"Lincoln County",1273,266,1570,1007,0.810828025477707,0.169426751592357,0.64140127388535
"Kansas",20107,"Linn County",3940,863,4903,3077,0.803589638996533,0.176014684886804,0.627574954109729
"Kansas",20109,"Logan County",1231,185,1437,1046,0.856645789839944,0.128740431454419,0.727905358385525
"Kansas",20111,"Lyon County",7381,5878,13622,1503,0.5418440757598,0.431507854940537,0.110336220819263
"Kansas",20113,"McPherson County",9562,3977,13868,5585,0.689501009518315,0.28677531006634,0.402725699451976
"Kansas",20115,"Marion County",4377,1463,5969,2914,0.733288658066678,0.245099681688725,0.488188976377953
"Kansas",20117,"Marshall County",3662,1239,5023,2423,0.729046386621541,0.246665339438582,0.482381047182958
"Kansas",20119,"Meade County",1508,261,1807,1247,0.83453237410072,0.144438295517432,0.690094078583287
"Kansas",20121,"Miami County",12116,5133,17624,6983,0.687471629596005,0.29125056740808,0.396221062187926
"Kansas",20123,"Mitchell County",2454,547,3039,1907,0.807502467917078,0.179993418887792,0.627509049029286
"Kansas",20125,"Montgomery County",9768,3147,13177,6621,0.741291644532139,0.238825225772179,0.502466418759961
"Kansas",20127,"Morris County",2085,721,2849,1364,0.731835731835732,0.253071253071253,0.478764478764479
"Kansas",20129,"Morton County",1004,147,1163,857,0.863284608770421,0.126397248495271,0.73688736027515
"Kansas",20131,"Nemaha County",4612,920,5625,3692,0.819911111111111,0.163555555555556,0.656355555555556
"Kansas",20133,"Neosho County",4795,1727,6629,3068,0.723336853220697,0.260521949011917,0.46281490420878
"Kansas",20135,"Ness County",1315,147,1487,1168,0.884330867518494,0.0988567585743107,0.785474108944183
"Kansas",20137,"Norton County",1977,361,2390,1616,0.827196652719665,0.151046025104603,0.676150627615063
"Kansas",20139,"Osage County",5591,2099,7893,3492,0.708349170150766,0.265931838337768,0.442417331812999
"Kansas",20141,"Osborne County",1590,275,1899,1315,0.837282780410742,0.144813059505003,0.69246972090574
"Kansas",20143,"Ottawa County",2581,504,3159,2077,0.817030705919595,0.15954415954416,0.657486546375435
"Kansas",20145,"Pawnee County",2028,635,2712,1393,0.747787610619469,0.234144542772861,0.513643067846608
"Kansas",20147,"Phillips County",2388,318,2752,2070,0.867732558139535,0.115552325581395,0.75218023255814
"Kansas",20149,"Pottawatomie County",9247,3257,12815,5990,0.721576277799454,0.254155286773313,0.467420991026141
"Kansas",20151,"Pratt County",3087,924,4107,2163,0.751643535427319,0.224981738495252,0.526661796932067
"Kansas",20153,"Rawlins County",1253,214,1496,1039,0.837566844919786,0.143048128342246,0.69451871657754
"Kansas",20155,"Reno County",17948,8602,27245,9346,0.658763075793724,0.315727656450725,0.343035419342999
"Kansas",20157,"Republic County",2172,420,2643,1752,0.821793416572077,0.158910329171396,0.662883087400681
"Kansas",20159,"Rice County",3187,953,4230,2234,0.753427895981088,0.225295508274232,0.528132387706856
"Kansas",20161,"Riley County",11174,11940,23855,-766,0.468413330538671,0.500523999161601,-0.0321106686229303
"Kansas",20163,"Rooks County",2294,332,2661,1962,0.862081924088688,0.124765125892522,0.737316798196167
"Kansas",20165,"Rush County",1425,291,1748,1134,0.815217391304348,0.166475972540046,0.648741418764302
"Kansas",20167,"Russell County",2765,591,3429,2174,0.806357538641003,0.172353455818023,0.63400408282298
"Kansas",20169,"Saline County",15313,8022,23911,7291,0.640416544686546,0.335494124043327,0.304922420643219
"Kansas",20171,"Scott County",1991,290,2322,1701,0.857450473729544,0.12489233419466,0.732558139534884
"Kansas",20173,"Sedgwick County",117653,90820,213552,26833,0.550933730426313,0.425282835094029,0.125650895332284
"Kansas",20175,"Seward County",3285,1736,5099,1549,0.644243969405766,0.340458913512453,0.303785055893312
"Kansas",20177,"Shawnee County",40443,43015,86122,-2572,0.469601263324122,0.499465873992708,-0.0298646106685864
"Kansas",20179,"Sheridan County",1237,144,1397,1093,0.885468861846815,0.103078024337867,0.782390837508948
"Kansas",20181,"Sherman County",2222,386,2673,1836,0.831275720164609,0.144407033295922,0.686868686868687
"Kansas",20183,"Smith County",1734,328,2092,1406,0.82887189292543,0.15678776290631,0.67208413001912
"Kansas",20185,"Stafford County",1631,355,2017,1276,0.808626673277144,0.176003966286564,0.63262270699058
"Kansas",20187,"Stanton County",607,147,767,460,0.791395045632334,0.191655801825293,0.59973924380704
"Kansas",20189,"Stevens County",1731,233,1997,1498,0.866800200300451,0.116675012518778,0.750125187781672
"Kansas",20191,"Sumner County",7998,2551,10779,5447,0.741998330086279,0.236663883477131,0.505334446609147
"Kansas",20193,"Thomas County",3106,622,3794,2484,0.818661043753295,0.163943068002109,0.654717975751186
"Kansas",20195,"Trego County",1341,238,1603,1103,0.836556456643793,0.148471615720524,0.688084840923269
"Kansas",20197,"Wabaunsee County",2813,956,3861,1857,0.728567728567729,0.247604247604248,0.480963480963481
"Kansas",20199,"Wallace County",762,44,817,718,0.932680538555692,0.0538555691554468,0.878824969400245
"Kansas",20201,"Washington County",2332,467,2843,1865,0.820260288427717,0.164263102356665,0.655997186071052
"Kansas",20203,"Wichita County",803,147,961,656,0.835587929240375,0.152965660770031,0.682622268470343
"Kansas",20205,"Wilson County",3111,711,3899,2400,0.797896896640164,0.182354449858938,0.615542446781226
"Kansas",20207,"Woodson County",1189,283,1495,906,0.795317725752508,0.189297658862876,0.606020066889632
"Kansas",20209,"Wyandotte County",18512,35566,55107,-17054,0.335928284972871,0.645398951131435,-0.309470666158564
"Kentucky",21001,"Adair County",7276,1392,8768,5884,0.829835766423358,0.158759124087591,0.671076642335766
"Kentucky",21003,"Allen County",7587,1642,9364,5945,0.810230670653567,0.175352413498505,0.634878257155062
"Kentucky",21005,"Anderson County",9661,3348,13254,6313,0.72891202655802,0.252602987777275,0.476309038780745
"Kentucky",21007,"Ballard County",3356,825,4225,2531,0.794319526627219,0.195266272189349,0.59905325443787
"Kentucky",21009,"Barren County",14654,5127,20064,9527,0.73036283891547,0.255532296650718,0.474830542264753
"Kentucky",21011,"Bath County",3986,1573,5627,2413,0.708370357206327,0.279545050648658,0.428825306557668
"Kentucky",21013,"Bell County",8140,1789,10044,6351,0.810434090003982,0.178116288331342,0.63231780167264
"Kentucky",21015,"Boone County",44814,20901,66998,23913,0.668885638377265,0.311964536254814,0.356921102122451
"Kentucky",21017,"Bourbon County",6190,3296,9648,2894,0.641583747927032,0.341625207296849,0.299958540630182
"Kentucky",21019,"Boyd County",14295,7083,21751,7212,0.657211162705163,0.325640200450554,0.331570962254609
"Kentucky",21021,"Boyle County",8872,5298,14478,3574,0.612791822074872,0.365934521342727,0.246857300732145
"Kentucky",21023,"Bracken County",3398,800,4246,2598,0.800282618935469,0.188412623645784,0.611869995289684
"Kentucky",21025,"Breathitt County",4265,1301,5661,2964,0.753400459282812,0.229818053347465,0.523582405935347
"Kentucky",21027,"Breckinridge County",7701,2350,10201,5351,0.75492598764827,0.230369571610626,0.524556416037643
"Kentucky",21029,"Bullitt County",30708,10552,41998,20156,0.731177675127387,0.251250059526644,0.479927615600743
"Kentucky",21031,"Butler County",4960,1079,6125,3881,0.809795918367347,0.176163265306122,0.633632653061225
"Kentucky",21033,"Caldwell County",4906,1433,6434,3473,0.762511656823127,0.222723033882499,0.539788622940628
"Kentucky",21035,"Calloway County",11352,5797,17457,5555,0.650283553875236,0.332073093887839,0.318210459987398
"Kentucky",21037,"Campbell County",28482,19374,48878,9108,0.58271615041532,0.396374647080486,0.186341503334834
"Kentucky",21039,"Carlisle County",2159,463,2638,1696,0.818423047763457,0.175511751326763,0.642911296436695
"Kentucky",21041,"Carroll County",2954,1116,4136,1838,0.7142166344294,0.269825918762089,0.444390715667311
"Kentucky",21043,"Carter County",8775,2642,11586,6133,0.757379596064215,0.228033833937511,0.529345762126705
"Kentucky",21045,"Casey County",6179,918,7171,5261,0.861665039743411,0.128015618463255,0.733649421280156
"Kentucky",21047,"Christian County",15080,8296,23863,6784,0.631940661274777,0.347651175459917,0.28428948581486
"Kentucky",21049,"Clark County",11811,6004,18139,5807,0.651138431005017,0.330999503831523,0.320138927173494
"Kentucky",21051,"Clay County",6677,831,7591,5846,0.879594256356211,0.109471742853379,0.770122513502832
"Kentucky",21053,"Clinton County",4280,603,4932,3677,0.867802108678021,0.122262773722628,0.745539334955393
"Kentucky",21055,"Crittenden County",3451,731,4242,2720,0.813531353135314,0.172324375294672,0.641206977840641
"Kentucky",21057,"Cumberland County",2769,508,3309,2261,0.836808703535811,0.153520701118163,0.683288002417649
"Kentucky",21059,"Daviess County",31025,17286,49287,13739,0.629476332501471,0.350721285531682,0.278755046969789
"Kentucky",21061,"Edmonson County",4828,1227,6132,3601,0.787345075016308,0.200097847358121,0.587247227658187
"Kentucky",21063,"Elliott County",2246,712,2995,1534,0.74991652754591,0.237729549248748,0.512186978297162
"Kentucky",21065,"Estill County",5100,1355,6540,3745,0.779816513761468,0.207186544342508,0.57262996941896
"Kentucky",21067,"Fayette County",58860,90600,152912,-31740,0.384927278434655,0.592497645704719,-0.207570367270064
"Kentucky",21069,"Fleming County",5534,1474,7068,4060,0.782965478211658,0.208545557441992,0.574419920769666
"Kentucky",21071,"Floyd County",12250,3884,16353,8366,0.749098024827249,0.237509937014615,0.511588087812634
"Kentucky",21073,"Franklin County",12900,12652,26072,248,0.494783675974225,0.48527155569193,0.0095121202822952
"Kentucky",21075,"Fulton County",1606,794,2426,812,0.66199505358615,0.327287716405606,0.334707337180544
"Kentucky",21077,"Gallatin County",2955,822,3849,2133,0.767731878409977,0.213561964146532,0.554169914263445
"Kentucky",21079,"Garrard County",6754,1830,8706,4924,0.775786813691707,0.210199862164025,0.565586951527682
"Kentucky",21081,"Grant County",8725,2205,11108,6520,0.785469931580843,0.198505581562838,0.586964350018005
"Kentucky",21083,"Graves County",13206,3560,17019,9646,0.775956284153005,0.209177977554498,0.566778306598507
"Kentucky",21085,"Grayson County",9453,2400,11985,7053,0.788735919899875,0.200250312891114,0.588485607008761
"Kentucky",21087,"Green County",4838,920,5812,3918,0.832415691672402,0.158293186510668,0.674122505161734
"Kentucky",21089,"Greenup County",13064,4873,18176,8191,0.71875,0.268100792253521,0.450649207746479
"Kentucky",21091,"Hancock County",3145,1351,4587,1794,0.685633311532592,0.294528013952474,0.391105297580118
"Kentucky",21093,"Hardin County",29832,18101,48941,11731,0.609550274820702,0.369853497067898,0.239696777752804
"Kentucky",21095,"Harlan County",9367,1494,10971,7873,0.853796372254125,0.136177194421657,0.717619177832467
"Kentucky",21097,"Harrison County",6334,2400,8859,3934,0.71497911728186,0.270910938029123,0.444068179252737
"Kentucky",21099,"Hart County",6345,1908,8370,4437,0.758064516129032,0.227956989247312,0.53010752688172
"Kentucky",21101,"Henderson County",12730,7639,20697,5091,0.615064985263565,0.369087307339228,0.245977677924337
"Kentucky",21103,"Henry County",5843,2142,8110,3701,0.720468557336621,0.264118372379778,0.456350184956843
"Kentucky",21105,"Hickman County",1714,458,2199,1256,0.779445202364711,0.208276489313324,0.571168713051387
"Kentucky",21107,"Hopkins County",15757,5439,21512,10318,0.732474897731499,0.252835626626999,0.4796392711045
"Kentucky",21109,"Jackson County",5453,605,6113,4848,0.892033371503353,0.0989694094552593,0.793063962048094
"Kentucky",21111,"Jefferson County",150646,228358,386629,-77712,0.389639680417144,0.590638570826296,-0.200998890409152
"Kentucky",21113,"Jessamine County",17096,8567,26280,8529,0.650532724505327,0.325989345509893,0.324543378995434
"Kentucky",21115,"Johnson County",8450,1608,10192,6842,0.829081632653061,0.157770800627943,0.671310832025118
"Kentucky",21117,"Kenton County",48129,32271,82198,15858,0.585525195260225,0.392600793206647,0.192924402053578
"Kentucky",21119,"Knott County",4780,1412,6252,3368,0.764555342290467,0.225847728726807,0.53870761356366
"Kentucky",21121,"Knox County",11012,2114,13273,8898,0.829654185187976,0.159270699917125,0.670383485270851
"Kentucky",21123,"Larue County",5685,1504,7301,4181,0.778660457471579,0.205999178194768,0.572661279276811
"Kentucky",21125,"Laurel County",23237,4475,28111,18762,0.826615915477927,0.159190352531038,0.667425562946889
"Kentucky",21127,"Lawrence County",5633,1238,6955,4395,0.809920920201294,0.178001437814522,0.631919482386772
"Kentucky",21129,"Lee County",2273,481,2801,1792,0.811495894323456,0.171724384148518,0.639771510174937
"Kentucky",21131,"Leslie County",4321,446,4813,3875,0.897776854352795,0.0926656970704342,0.80511115728236
"Kentucky",21133,"Letcher County",7226,1799,9135,5427,0.791023535851122,0.196934865900383,0.594088669950739
"Kentucky",21135,"Lewis County",4986,823,5883,4163,0.847526772055074,0.139894611592725,0.707632160462349
"Kentucky",21137,"Lincoln County",8489,2254,10914,6235,0.777808319589518,0.206523730987722,0.571284588601796
"Kentucky",21139,"Livingston County",4010,939,5004,3071,0.801358912869704,0.187649880095923,0.613709032773781
"Kentucky",21141,"Logan County",9067,3094,12350,5973,0.73417004048583,0.250526315789474,0.483643724696356
"Kentucky",21143,"Lyon County",3100,1092,4228,2008,0.733207190160833,0.258278145695364,0.474929044465468
"Kentucky",21145,"McCracken County",21820,11195,33549,10625,0.650391963992966,0.333691019106382,0.316700944886584
"Kentucky",21147,"McCreary County",5664,725,6438,4939,0.87977632805219,0.112612612612613,0.767163715439578
"Kentucky",21149,"McLean County",3633,1074,4782,2559,0.759723964868256,0.224592220828105,0.535131744040151
"Kentucky",21151,"Madison County",27356,15581,43957,11775,0.622335464203654,0.354460040494119,0.267875423709534
"Kentucky",21153,"Magoffin County",4174,1214,5447,2960,0.766293372498623,0.222874977051588,0.543418395447035
"Kentucky",21155,"Marion County",6113,2722,8928,3391,0.68469982078853,0.304883512544803,0.379816308243728
"Kentucky",21157,"Marshall County",13297,4071,17603,9226,0.755382605237744,0.231267397602681,0.524115207635062
"Kentucky",21159,"Martin County",3496,403,3936,3093,0.888211382113821,0.102388211382114,0.785823170731707
"Kentucky",21161,"Mason County",5477,2362,7958,3115,0.688238250816788,0.296808243277205,0.391430007539583
"Kentucky",21163,"Meade County",10185,3632,14113,6553,0.721675051371076,0.257351378161978,0.464323673209098
"Kentucky",21165,"Menifee County",2311,750,3102,1561,0.745003223726628,0.241779497098646,0.503223726627982
"Kentucky",21167,"Mercer County",8506,3033,11735,5473,0.724840221559438,0.258457605453771,0.466382616105667
"Kentucky",21169,"Metcalfe County",3959,975,5012,2984,0.789904229848364,0.194533120510774,0.59537110933759
"Kentucky",21171,"Monroe County",4628,657,5330,3971,0.868292682926829,0.123264540337711,0.745028142589118
"Kentucky",21173,"Montgomery County",8993,3630,12842,5363,0.700280330166641,0.282666251362716,0.417614078803925
"Kentucky",21175,"Morgan County",4301,1175,5544,3126,0.775793650793651,0.211940836940837,0.563852813852814
"Kentucky",21177,"Muhlenberg County",10497,3545,14235,6952,0.73740779768177,0.249034070951879,0.488373726729891
"Kentucky",21179,"Nelson County",15703,7188,23256,8515,0.675223598211214,0.309081527347781,0.366142070863433
"Kentucky",21181,"Nicholas County",2408,955,3396,1453,0.70906949352179,0.281213191990577,0.427856301531213
"Kentucky",21183,"Ohio County",8582,2404,11129,6178,0.77113846706802,0.216012220325276,0.555126246742744
"Kentucky",21185,"Oldham County",22654,14505,37976,8149,0.596534653465347,0.381951759005688,0.214582894459659
"Kentucky",21187,"Owen County",4292,1098,5458,3194,0.786368633198974,0.201172590692561,0.585196042506413
"Kentucky",21189,"Owsley County",1671,216,1896,1455,0.881329113924051,0.113924050632911,0.767405063291139
"Kentucky",21191,"Pendleton County",5515,1322,6925,4193,0.796389891696751,0.190902527075812,0.605487364620939
"Kentucky",21193,"Perry County",8129,2356,10626,5773,0.765010351966874,0.22172030867683,0.543290043290043
"Kentucky",21195,"Pike County",20284,4866,25395,15418,0.79873990943099,0.19161252215003,0.607127387280961
"Kentucky",21197,"Powell County",4041,1367,5505,2674,0.734059945504087,0.248319709355132,0.485740236148955
"Kentucky",21199,"Pulaski County",25442,5666,31557,19776,0.806223658776183,0.17954811927623,0.626675539499952
"Kentucky",21201,"Robertson County",884,253,1146,631,0.771378708551483,0.220767888307155,0.550610820244328
"Kentucky",21203,"Rockcastle County",6577,1134,7784,5443,0.844938335046249,0.14568345323741,0.699254881808839
"Kentucky",21205,"Rowan County",5994,3880,10065,2114,0.595529061102832,0.385494287133631,0.2100347739692
"Kentucky",21207,"Russell County",7519,1331,8955,6188,0.83964265773311,0.148632049134562,0.691010608598548
"Kentucky",21209,"Scott County",17767,10567,28969,7200,0.613310780489489,0.364769236079948,0.248541544409541
"Kentucky",21211,"Shelby County",15055,8077,23550,6978,0.63927813163482,0.342972399150743,0.296305732484076
"Kentucky",21213,"Simpson County",5888,2681,8732,3207,0.674301420064132,0.307031607879066,0.367269812185066
"Kentucky",21215,"Spencer County",8737,2530,11433,6207,0.764191375841861,0.221289250415464,0.542902125426397
"Kentucky",21217,"Taylor County",9376,2963,12517,6413,0.749061276663737,0.23671806343373,0.512343213230007
"Kentucky",21219,"Todd County",4062,1205,5363,2857,0.757411896326683,0.224687674808876,0.532724221517807
"Kentucky",21221,"Trigg County",5487,1791,7376,3696,0.743899132321041,0.24281453362256,0.501084598698482
"Kentucky",21223,"Trimble County",3227,1012,4320,2215,0.746990740740741,0.234259259259259,0.512731481481482
"Kentucky",21225,"Union County",4965,1529,6577,3436,0.754903451421621,0.232476813136688,0.522426638284932
"Kentucky",21227,"Warren County",31791,22479,55401,9312,0.573834407321168,0.405750798722045,0.168083608599123
"Kentucky",21229,"Washington County",4482,1644,6225,2838,0.72,0.264096385542169,0.455903614457831
"Kentucky",21231,"Wayne County",7430,1700,9240,5730,0.804112554112554,0.183982683982684,0.62012987012987
"Kentucky",21233,"Webster County",4506,1412,5993,3094,0.751877190055064,0.235608209577841,0.516268980477223
"Kentucky",21235,"Whitley County",12567,2552,15356,10015,0.818377181557697,0.166189111747851,0.652188069809846
"Kentucky",21237,"Wolfe County",2097,839,2979,1258,0.70392749244713,0.28163813360188,0.42228935884525
"Kentucky",21239,"Woodford County",8362,6530,15211,1832,0.54973374531589,0.429294589441851,0.120439155874039
"Louisiana",22001,"Acadia Parish",22596,5443,28425,17153,0.794934036939314,0.191486367634125,0.603447669305189
"Louisiana",22003,"Allen Parish",7574,2108,9810,5466,0.772069317023446,0.214882772680938,0.557186544342508
"Louisiana",22005,"Ascension Parish",40687,20399,62325,20288,0.652819895707982,0.327300441235459,0.325519454472523
"Louisiana",22007,"Assumption Parish",7271,3833,11235,3438,0.647174009790832,0.341165999109924,0.306008010680908
"Louisiana",22009,"Avoyelles Parish",12028,4979,17292,7049,0.69558177191765,0.28793661808929,0.40764515382836
"Louisiana",22011,"Beauregard Parish",13575,2542,16357,11033,0.829919911964297,0.155407470807605,0.674512441156691
"Louisiana",22013,"Bienville Parish",3891,3067,7050,824,0.551914893617021,0.435035460992908,0.116879432624113
"Louisiana",22015,"Bossier Parish",38074,15662,54655,22412,0.69662427957186,0.286561156344342,0.410063123227518
"Louisiana",22017,"Caddo Parish",48021,55110,104912,-7089,0.457726475522343,0.525297392100046,-0.0675709165777033
"Louisiana",22019,"Calcasieu Parish",55066,25982,82663,29084,0.666150514740573,0.314312328369403,0.35183818637117
"Louisiana",22021,"Caldwell Parish",3976,745,4762,3231,0.834943301133977,0.156446871062579,0.678496430071399
"Louisiana",22023,"Cameron Parish",3671,324,4039,3347,0.908888338697698,0.0802178757118099,0.828670462985888
"Louisiana",22025,"Catahoula Parish",3541,1269,4858,2272,0.728900782214903,0.261218608480856,0.467682173734047
"Louisiana",22027,"Claiborne Parish",3770,2731,6580,1039,0.572948328267477,0.415045592705167,0.15790273556231
"Louisiana",22029,"Concordia Parish",5550,3177,8828,2373,0.628681468056185,0.359877661984594,0.26880380607159
"Louisiana",22031,"De Soto Parish",9112,5457,14736,3655,0.618349619978285,0.370317589576547,0.248032030401737
"Louisiana",22033,"East Baton Rouge Parish",88420,115577,208182,-27157,0.424724519891249,0.555172877578273,-0.130448357687024
"Louisiana",22035,"East Carroll Parish",1080,1900,3036,-820,0.355731225296443,0.625823451910408,-0.270092226613966
"Louisiana",22037,"East Feliciana Parish",6064,4280,10509,1784,0.577029213055476,0.407269959082691,0.169759253972785
"Louisiana",22039,"Evangeline Parish",11053,4158,15412,6895,0.717168440176486,0.269789774201921,0.447378665974565
"Louisiana",22041,"Franklin Parish",6970,2658,9720,4312,0.717078189300412,0.273456790123457,0.443621399176955
"Louisiana",22043,"Grant Parish",8117,1157,9392,6960,0.864246166950596,0.123189948892675,0.741056218057922
"Louisiana",22045,"Iberia Parish",21251,11027,32713,10224,0.649619417357014,0.337083116803717,0.312536300553297
"Louisiana",22047,"Iberville Parish",7893,8514,16719,-621,0.47209761349363,0.509240983312399,-0.0371433698187691
"Louisiana",22049,"Jackson Parish",5394,2143,7632,3251,0.706761006289308,0.280791404612159,0.425969601677149
"Louisiana",22051,"Jefferson Parish",105949,84477,193733,21472,0.546881532831268,0.436048582327224,0.110832950504044
"Louisiana",22053,"Jefferson Davis Parish",11423,3208,14841,8215,0.76969206926757,0.216157940839566,0.553534128428004
"Louisiana",22055,"Lafayette Parish",72519,39685,114521,32834,0.63323757214834,0.346530330681709,0.286707241466631
"Louisiana",22057,"Lafourche Parish",36024,8672,45388,27352,0.793689962104521,0.191063717282101,0.60262624482242
"Louisiana",22059,"LaSalle Parish",6378,638,7077,5740,0.901229334463756,0.0901511940087608,0.811078140454995
"Louisiana",22061,"Lincoln Parish",11311,7559,19275,3752,0.586822308690013,0.392166018158236,0.194656290531777
"Louisiana",22063,"Livingston Parish",54877,9249,65230,45628,0.841284684960908,0.14179058715315,0.699494097807757
"Louisiana",22065,"Madison Parish",1930,2654,4670,-724,0.413276231263383,0.56830835117773,-0.155032119914347
"Louisiana",22067,"Morehouse Parish",6510,4946,11574,1564,0.562467599792639,0.427337134957664,0.135130464834975
"Louisiana",22069,"Natchitoches Parish",9358,6896,16554,2462,0.56530143771898,0.416576054125891,0.148725383593089
"Louisiana",22071,"Orleans Parish",26664,147854,177819,-121190,0.149950230290351,0.83148594919553,-0.681535718905179
"Louisiana",22073,"Ouachita Parish",42255,25913,69166,16342,0.610921551051094,0.374649394211029,0.236272156840066
"Louisiana",22075,"Plaquemines Parish",7412,3414,11014,3998,0.672961685128019,0.30996913019793,0.362992554930089
"Louisiana",22077,"Pointe Coupee Parish",7503,4683,12371,2820,0.606499070406596,0.37854660092151,0.227952469485086
"Louisiana",22079,"Rapides Parish",38347,19475,58865,18872,0.651439734986834,0.330841756561624,0.32059797842521
"Louisiana",22081,"Red River Parish",2413,1644,4132,769,0.583978702807357,0.397870280735721,0.186108422071636
"Louisiana",22083,"Richland Parish",6607,3225,9940,3382,0.664688128772636,0.324446680080483,0.340241448692153
"Louisiana",22085,"Sabine Parish",8776,1731,10596,7045,0.828237070592676,0.163363533408834,0.664873537183843
"Louisiana",22087,"St. Bernard Parish",11179,6151,17650,5028,0.633371104815864,0.348498583569405,0.284872521246459
"Louisiana",22089,"St. Charles Parish",18233,9800,28517,8433,0.639373005575622,0.34365466213136,0.295718343444261
"Louisiana",22091,"St. Helena Parish",2714,3346,6158,-632,0.440727508931471,0.543358233192595,-0.102630724261124
"Louisiana",22093,"St. James Parish",5954,6510,12590,-556,0.472915011914218,0.517077045274027,-0.0441620333598093
"Louisiana",22095,"St. John the Baptist Parish",7538,13582,21432,-6044,0.351717058603957,0.633725270623367,-0.28200821201941
"Louisiana",22097,"St. Landry Parish",23171,17372,41154,5799,0.563031540069009,0.422121786460611,0.140909753608398
"Louisiana",22099,"St. Martin Parish",18203,8439,27038,9764,0.673237665507804,0.312116280789999,0.361121384717805
"Louisiana",22101,"St. Mary Parish",14811,8055,23186,6756,0.638790649529889,0.347407918571552,0.291382730958337
"Louisiana",22103,"St. Tammany Parish",99666,37746,140110,61920,0.711341089144244,0.269402612233245,0.441938476910998
"Louisiana",22105,"Tangipahoa Parish",37806,18887,57661,18919,0.655659804720695,0.327552418445743,0.328107386274952
"Louisiana",22107,"Tensas Parish",1197,1329,2554,-132,0.468676585747847,0.5203602192639,-0.0516836335160532
"Louisiana",22109,"Terrebonne Parish",34339,11198,46240,23141,0.742625432525952,0.242171280276817,0.500454152249135
"Louisiana",22111,"Union Parish",8407,2654,11201,5753,0.750557985894117,0.236943130077672,0.513614855816445
"Louisiana",22113,"Vermilion Parish",21930,5009,27324,16921,0.802591128678085,0.183318694188259,0.619272434489826
"Louisiana",22115,"Vernon Parish",14107,2898,17268,11209,0.816944637479731,0.167824878387769,0.649119759091962
"Louisiana",22117,"Washington Parish",13307,5970,19513,7337,0.681955619330703,0.305949879567468,0.376005739763235
"Louisiana",22119,"Webster Parish",11830,6172,18216,5658,0.649429073342117,0.338823012736056,0.310606060606061
"Louisiana",22121,"West Baton Rouge Parish",7684,6200,14097,1484,0.545080513584451,0.439809888628786,0.105270624955664
"Louisiana",22123,"West Carroll Parish",4317,710,5052,3607,0.854513064133017,0.140538400633412,0.713974663499604
"Louisiana",22125,"West Feliciana Parish",3863,2298,6268,1565,0.616305041480536,0.366624122527122,0.249680918953414
"Louisiana",22127,"Winn Parish",4619,1543,6225,3076,0.742008032128514,0.247871485943775,0.494136546184739
"Maine",23001,"Androscoggin County",29268,27617,58707,1651,0.498543614901119,0.470420903810448,0.0281227110906706
"Maine",23003,"Aroostook County",21080,13956,35746,7124,0.589716331897275,0.390421305880378,0.199295026016897
"Maine",23005,"Cumberland County",59584,128759,193765,-69175,0.307506515624597,0.664511134621836,-0.357004618997239
"Maine",23007,"Franklin County",8754,8069,17390,685,0.503392754456584,0.464002300172513,0.0393904542840713
"Maine",23009,"Hancock County",14982,19369,35325,-4387,0.42411889596603,0.54830856334041,-0.124189667374381
"Maine",23011,"Kennebec County",34721,34902,71858,-181,0.483189067327229,0.485707923961146,-0.00251885663391688
"Maine",23013,"Knox County",9982,15110,25734,-5128,0.387891505401414,0.58716095437942,-0.199269448978006
"Maine",23015,"Lincoln County",10256,12684,23594,-2428,0.43468678477579,0.537594303636518,-0.102907518860727
"Maine",23017,"Oxford County",17698,14755,33492,2943,0.528424698435447,0.440552967872925,0.0878717305625224
"Maine",23019,"Penobscot County",44825,37713,85269,7112,0.525689289190679,0.442282658410442,0.0834066307802367
"Maine",23021,"Piscataquis County",6143,3517,9908,2626,0.620004037141704,0.354965684295519,0.265038352846185
"Maine",23023,"Sagadahoc County",9755,13528,24038,-3773,0.4058157916632,0.562775605291622,-0.156959813628422
"Maine",23025,"Somerset County",16644,10199,27578,6445,0.603524548553195,0.36982377257234,0.233700775980854
"Maine",23027,"Waldo County",11196,12345,24320,-1149,0.460361842105263,0.507606907894737,-0.0472450657894737
"Maine",23029,"Washington County",10194,6761,17357,3433,0.587313475831077,0.389525839718845,0.197787636112231
"Maine",23031,"York County",54817,71189,129659,-16372,0.42277821053687,0.54904788715014,-0.12626967661327
"Maryland",24001,"Allegany County",20886,9158,30641,11728,0.681635716849972,0.29888058483731,0.382755132012663
"Maryland",24003,"Anne Arundel County",127821,172823,309617,-45002,0.412835858496142,0.55818317469648,-0.145347316200338
"Maryland",24005,"Baltimore County",146202,258409,414932,-112207,0.352351710641744,0.622774334107757,-0.270422623466014
"Maryland",24009,"Calvert County",25346,22587,49112,2759,0.516085681707118,0.459907965466688,0.0561777162404301
"Maryland",24011,"Caroline County",10283,5095,15794,5188,0.651070026592377,0.322590857287578,0.328479169304799
"Maryland",24013,"Carroll County",60218,36456,100327,23762,0.600217289463455,0.363371774298045,0.236845515165409
"Maryland",24015,"Cecil County",29439,16809,47462,12630,0.620264632758839,0.354157009818381,0.266107622940458
"Maryland",24017,"Charles County",25579,62171,89498,-36592,0.285805269391495,0.694663567900959,-0.408858298509464
"Maryland",24019,"Dorchester County",8764,6857,15977,1907,0.548538524128435,0.429179445452838,0.119359078675596
"Maryland",24021,"Frederick County",63682,77675,145615,-13993,0.437331318888851,0.533427188133091,-0.0960958692442399
"Maryland",24023,"Garrett County",12002,3281,15611,8721,0.768816859906476,0.210172314393697,0.558644545512779
"Maryland",24025,"Harford County",80930,63095,148186,17835,0.546137961750773,0.425782462580811,0.120355499169962
"Maryland",24027,"Howard County",48390,129433,183062,-81043,0.26433667282123,0.707044607837782,-0.442707935016552
"Maryland",24029,"Kent County",5195,5329,10794,-134,0.481285899573837,0.493700203816935,-0.012414304243098
"Maryland",24031,"Montgomery County",101222,419569,533743,-318347,0.189645578490022,0.786088061108061,-0.596442482618039
"Maryland",24033,"Prince George's County",37090,379208,424855,-342118,0.0873003730684587,0.892558637652846,-0.805258264584388
"Maryland",24035,"Queen Anne's County",18741,10709,30290,8032,0.618719049191152,0.353549026081215,0.265170023109937
"Maryland",24037,"St. Mary's County",30826,23138,55665,7688,0.553777059193389,0.415665139674841,0.138111919518548
"Maryland",24039,"Somerset County",5739,4241,10147,1498,0.56558588745442,0.417956046122006,0.147629841332414
"Maryland",24041,"Talbot County",10946,11062,22555,-116,0.485302593659942,0.490445577477278,-0.00514298381733536
"Maryland",24043,"Washington County",40224,26044,67779,14180,0.593458150754659,0.384248808628041,0.209209342126617
"Maryland",24045,"Wicomico County",22944,22054,46216,890,0.496451445386879,0.477194045352259,0.0192574000346201
"Maryland",24047,"Worcester County",18571,12560,31691,6011,0.586002335047805,0.396327032911552,0.189675302136253
"Maryland",24510,"Baltimore city",25374,207260,237461,-181886,0.106855441525135,0.872817009951108,-0.765961568425973
"Massachusetts",25001,"Barnstable County",55311,91994,150325,-36683,0.367942790620323,0.611967403958091,-0.244024613337768
"Massachusetts",25003,"Berkshire County",18064,51705,71375,-33641,0.253085814360771,0.724413309982487,-0.471327495621716
"Massachusetts",25005,"Bristol County",119872,153377,279279,-33505,0.42921952599372,0.549189162092388,-0.119969636098668
"Massachusetts",25007,"Dukes County",2631,9914,12798,-7283,0.205578996718237,0.774652289420222,-0.569073292701985
"Massachusetts",25009,"Essex County",144837,267198,421210,-122361,0.34385935756511,0.634358158638209,-0.290498801073099
"Massachusetts",25011,"Franklin County",11201,30030,42458,-18829,0.263813651137595,0.707287201469688,-0.443473550332093
"Massachusetts",25013,"Hampden County",87318,125948,218177,-38630,0.4002163381108,0.577274414809994,-0.177058076699194
"Massachusetts",25015,"Hampshire County",22281,63362,87854,-41081,0.253613950417739,0.7212192956496,-0.467605345231862
"Massachusetts",25017,"Middlesex County",226956,617196,863577,-390240,0.262809222570772,0.714697126023505,-0.451887903452732
"Massachusetts",25019,"Nantucket County",1914,5241,7306,-3327,0.261976457705995,0.717355598138516,-0.455379140432521
"Massachusetts",25021,"Norfolk County",125294,273312,407751,-148018,0.307280668839561,0.670291427856707,-0.363010759017145
"Massachusetts",25023,"Plymouth County",121227,173630,301816,-52403,0.401658626447902,0.575284279163464,-0.173625652715562
"Massachusetts",25025,"Suffolk County",58613,270522,335462,-211909,0.174723217532835,0.806416225980886,-0.631693008448051
"Massachusetts",25027,"Worcester County",171683,248773,432014,-77090,0.397401473100409,0.575844764290046,-0.178443291189637
"Michigan",26001,"Alcona County",4848,2142,7064,2706,0.686296715741789,0.303227633069083,0.383069082672707
"Michigan",26003,"Alger County",3014,2053,5128,961,0.587753510140406,0.400351014040562,0.187402496099844
"Michigan",26005,"Allegan County",41392,24449,67094,16943,0.616925507496945,0.364399201120816,0.252526306376129
"Michigan",26007,"Alpena County",10686,6000,16969,4686,0.629736578466616,0.353585950851553,0.276150627615063
"Michigan",26009,"Antrim County",9748,5960,15949,3788,0.611198194244153,0.373691140510377,0.237507053733776
"Michigan",26011,"Arenac County",5928,2774,8831,3154,0.671271656664024,0.314120711131242,0.357150945532782
"Michigan",26013,"Baraga County",2512,1478,4038,1034,0.622090143635463,0.366022783556216,0.256067360079247
"Michigan",26015,"Barry County",23471,11797,35905,11674,0.653697256649492,0.328561481687787,0.325135774961705
"Michigan",26017,"Bay County",33125,26151,60255,6974,0.54974690897021,0.434005476723923,0.115741432246287
"Michigan",26019,"Benzie County",6601,5480,12262,1121,0.538329799380199,0.446909150220192,0.0914206491600065
"Michigan",26021,"Berrien County",43519,37438,82391,6081,0.528200895728902,0.454394290638541,0.0738066050903617
"Michigan",26023,"Branch County",14064,6159,20536,7905,0.684846123880016,0.299912349045579,0.384933774834437
"Michigan",26025,"Calhoun County",36221,28877,66281,7344,0.546476365776014,0.435675382085364,0.11080098369065
"Michigan",26027,"Cass County",16699,9130,26216,7569,0.636977418370461,0.348260604211169,0.288716814159292
"Michigan",26029,"Charlevoix County",9841,6939,17000,2902,0.578882352941177,0.408176470588235,0.170705882352941
"Michigan",26031,"Cheboygan County",10186,5437,15868,4749,0.641920846987648,0.342639274010587,0.299281572977061
"Michigan",26033,"Chippewa County",10681,6648,17642,4033,0.605430223330688,0.376828024033556,0.228602199297132
"Michigan",26035,"Clare County",10861,5199,16281,5662,0.667096615686997,0.319329279528284,0.347767336158713
"Michigan",26037,"Clinton County",25098,21968,47927,3130,0.523671416946606,0.45836376155403,0.0653076553925763
"Michigan",26039,"Crawford County",5087,2672,7861,2415,0.647118687189925,0.339905864393843,0.307212822796082
"Michigan",26041,"Delta County",13207,7606,21151,5601,0.624414921280318,0.359604746820481,0.264810174459836
"Michigan",26043,"Dickinson County",9617,4744,14589,4873,0.659195284118171,0.325176502844609,0.334018781273562
"Michigan",26045,"Eaton County",31798,31299,64327,499,0.494318093491069,0.486560853140983,0.00775724035008629
"Michigan",26047,"Emmet County",12135,9662,22177,2473,0.547188528655815,0.435676601884836,0.111511926770979
"Michigan",26049,"Genesee County",98714,119390,221360,-20676,0.445943259848211,0.539347668955548,-0.0934044091073365
"Michigan",26051,"Gladwin County",9893,4524,14603,5369,0.677463534890091,0.309799356296651,0.36766417859344
"Michigan",26053,"Gogebic County",4600,3570,8266,1030,0.556496491652553,0.431889668521655,0.124606823130898
"Michigan",26055,"Grand Traverse County",30502,28683,60236,1819,0.506374925293844,0.476177036987848,0.0301978883059964
"Michigan",26057,"Gratiot County",12102,6693,19127,5409,0.63271814712187,0.349924190934281,0.282793956187588
"Michigan",26059,"Hillsdale County",17037,5883,23302,11154,0.731138958029354,0.252467599347695,0.478671358681658
"Michigan",26061,"Houghton County",10378,7750,18501,2628,0.560942651748554,0.41889627587698,0.142046375871575
"Michigan",26063,"Huron County",12731,5490,18437,7241,0.690513641047893,0.297770787004393,0.392742854043499
"Michigan",26065,"Ingham County",47639,94212,144550,-46573,0.329567623659633,0.651760636457973,-0.32219301279834
"Michigan",26067,"Ionia County",20657,10901,32209,9756,0.641342481914993,0.338445776025335,0.302896705889658
"Michigan",26069,"Iosco County",9759,5373,15363,4386,0.635227494629955,0.349736379613357,0.285491115016598
"Michigan",26071,"Iron County",4216,2493,6789,1723,0.621004566210046,0.367211665930181,0.253792900279864
"Michigan",26073,"Isabella County",14815,14072,29421,743,0.503551884708202,0.478297814486251,0.0252540702219504
"Michigan",26075,"Jackson County",47372,31995,80861,15377,0.585844844857224,0.395679004711789,0.190165840145435
"Michigan",26077,"Kalamazoo County",56823,83686,143414,-26863,0.3962165478963,0.583527410155215,-0.187310862258915
"Michigan",26079,"Kalkaska County",7436,3002,10631,4434,0.699463832188882,0.282381713855705,0.417082118333176
"Michigan",26081,"Kent County",165741,187915,361048,-22174,0.459055305665729,0.520470962309721,-0.0614156566439919
"Michigan",26083,"Keweenaw County",862,672,1557,190,0.553628773281952,0.431599229287091,0.122029543994862
"Michigan",26085,"Lake County",3946,2288,6323,1658,0.62407085244346,0.361853550529812,0.262217301913649
"Michigan",26087,"Lapeer County",35482,16367,52650,19115,0.673922127255461,0.310864197530864,0.363057929724596
"Michigan",26089,"Leelanau County",7916,8795,16900,-879,0.468402366863905,0.520414201183432,-0.0520118343195266
"Michigan",26091,"Lenawee County",31541,20918,53375,10623,0.590932084309133,0.391906323185012,0.199025761124122
"Michigan",26093,"Livingston County",76982,48220,127197,28762,0.605218676541113,0.379096991281241,0.226121685259872
"Michigan",26095,"Luce County",2109,842,3001,1267,0.70276574475175,0.280573142285905,0.422192602465845
"Michigan",26097,"Mackinac County",4304,2632,7015,1672,0.613542409123307,0.3751960085531,0.238346400570207
"Michigan",26099,"Macomb County",263863,223952,494256,39911,0.533858971868829,0.453109319866628,0.0807496520022013
"Michigan",26101,"Manistee County",8321,6107,14655,2214,0.567792562265438,0.416717843739338,0.1510747185261
"Michigan",26103,"Marquette County",16286,20465,37462,-4179,0.434733863648497,0.546286904062784,-0.111553040414286
"Michigan",26105,"Mason County",10207,6802,17254,3405,0.591572968586994,0.394227425524516,0.197345543062478
"Michigan",26107,"Mecosta County",13267,7375,21049,5892,0.630291225236353,0.350372939332035,0.279918285904318
"Michigan",26109,"Menominee County",8117,4316,12607,3801,0.643848655508844,0.342349488379472,0.301499167129373
"Michigan",26111,"Midland County",27675,20493,49088,7182,0.563783409387223,0.417474739243807,0.146308670143416
"Michigan",26113,"Missaukee County",6648,1967,8755,4681,0.759337521416333,0.224671616219303,0.53466590519703
"Michigan",26115,"Monroe County",52710,32975,87148,19735,0.604833157387433,0.378379308762106,0.226453848625327
"Michigan",26117,"Montcalm County",21815,9703,32100,12112,0.679595015576324,0.302274143302181,0.377320872274143
"Michigan",26119,"Montmorency County",4171,1628,5859,2543,0.71189622802526,0.277863116572794,0.434033111452466
"Michigan",26121,"Muskegon County",45133,45643,92444,-510,0.488219895287958,0.493736748734369,-0.00551685344641079
"Michigan",26123,"Newaygo County",18857,7873,27161,10984,0.694267515923567,0.289864143440963,0.404403372482604
"Michigan",26125,"Oakland County",325971,434148,770351,-108177,0.423146072374801,0.56357167057614,-0.140425598201339
"Michigan",26127,"Oceana County",8892,4944,14062,3948,0.632342483288295,0.351585834162992,0.280756649125302
"Michigan",26129,"Ogemaw County",8253,3475,11907,4778,0.693121693121693,0.291845133114974,0.401276560006719
"Michigan",26131,"Ontonagon County",2358,1391,3804,967,0.6198738170347,0.365667718191377,0.254206098843323
"Michigan",26133,"Osceola County",8928,3214,12329,5714,0.72414632168059,0.260686187038689,0.463460134641901
"Michigan",26135,"Oscoda County",3466,1342,4874,2124,0.711120229790726,0.275338530980714,0.435781698810012
"Michigan",26137,"Otsego County",9779,4743,14757,5036,0.662668564071288,0.321406789997967,0.341261774073321
"Michigan",26139,"Ottawa County",100913,64705,168713,36208,0.598134109404729,0.383521127595384,0.214612981809345
"Michigan",26141,"Presque Isle County",5342,2911,8344,2431,0.640220517737296,0.348873441994247,0.291347075743049
"Michigan",26143,"Roscommon County",9670,5166,15018,4504,0.643893993874018,0.34398721534159,0.299906778532428
"Michigan",26145,"Saginaw County",50785,51088,103349,-303,0.491393240379684,0.494325053943434,-0.00293181356375005
"Michigan",26147,"St. Clair County",59185,31363,92064,27822,0.64286800486618,0.340665189433438,0.302202815432742
"Michigan",26149,"St. Joseph County",18127,9262,27936,8865,0.648876002290951,0.331543528064147,0.317332474226804
"Michigan",26151,"Sanilac County",16194,5966,22446,10228,0.721464848970863,0.265793459859218,0.455671389111646
"Michigan",26153,"Schoolcraft County",3090,1589,4745,1501,0.651211801896733,0.334878819810327,0.316332982086407
"Michigan",26155,"Shiawassee County",23149,15347,39224,7802,0.590174383030798,0.391265551703039,0.198908831327759
"Michigan",26157,"Tuscola County",20297,8712,29445,11585,0.68931906945152,0.29587366276108,0.39344540669044
"Michigan",26159,"Van Buren County",21591,16803,39066,4788,0.552680079864844,0.430118261403778,0.122561818461066
"Michigan",26161,"Washtenaw County",56241,157136,216418,-100895,0.259872099363269,0.72607638920977,-0.466204289846501
"Michigan",26163,"Wayne County",264553,597170,872469,-332617,0.303223381002649,0.684459849003231,-0.381236468000582
"Michigan",26165,"Wexford County",12102,5838,18265,6264,0.662578702436354,0.319627703257596,0.342950999178757
"Minnesota",27001,"Aitkin County",6258,3607,10025,2651,0.624239401496259,0.359800498753117,0.264438902743142
"Minnesota",27003,"Anoka County",104902,100893,211132,4009,0.496855048026827,0.477866926851448,0.0189881211753785
"Minnesota",27005,"Becker County",12438,6589,19401,5849,0.641100974176589,0.339621668986135,0.301479305190454
"Minnesota",27007,"Beltrami County",12188,11426,24189,762,0.503865393360618,0.472363470999214,0.0315019223614039
"Minnesota",27009,"Benton County",14382,7280,22260,7102,0.646091644204852,0.327044025157233,0.319047619047619
"Minnesota",27011,"Big Stone County",1863,1053,2974,810,0.626429051782112,0.354068594485541,0.27236045729657
"Minnesota",27013,"Blue Earth County",16731,18330,36051,-1599,0.464092535574603,0.508446367645835,-0.0443538320712324
"Minnesota",27015,"Brown County",9552,4753,14635,4799,0.652681926887598,0.32476938845234,0.327912538435258
"Minnesota",27017,"Carlton County",9791,10098,20369,-307,0.480681427659679,0.495753350679955,-0.0150719230202759
"Minnesota",27019,"Carver County",34009,30774,66361,3235,0.512484742544567,0.463736230617381,0.0487485119271862
"Minnesota",27021,"Cass County",11620,6342,18289,5278,0.635354584723058,0.346765815517524,0.288588769205533
"Minnesota",27023,"Chippewa County",4250,2226,6611,2024,0.64286794736046,0.336711541370443,0.306156405990017
"Minnesota",27025,"Chisago County",21916,11806,34570,10110,0.633960080995082,0.341509979751229,0.292450101243853
"Minnesota",27027,"Clay County",15043,16357,32239,-1314,0.466608765780576,0.507366853810602,-0.0407580880300258
"Minnesota",27029,"Clearwater County",3372,1260,4708,2112,0.716227697536109,0.267629566694987,0.448598130841121
"Minnesota",27031,"Cook County",1203,2496,3806,-1293,0.316079873883342,0.65580662112454,-0.339726747241198
"Minnesota",27033,"Cottonwood County",4165,1834,6107,2331,0.68200425740953,0.300311118388734,0.381693139020796
"Minnesota",27035,"Crow Wing County",25676,13726,40173,11950,0.639135737933438,0.341672267443308,0.29746347049013
"Minnesota",27037,"Dakota County",109638,146155,262259,-36517,0.418052383330982,0.557292600063296,-0.139240216732314
"Minnesota",27039,"Dodge County",7783,4079,12187,3704,0.638631328464758,0.334700910806597,0.30393041765816
"Minnesota",27041,"Douglas County",15799,7868,24165,7931,0.65379681357335,0.325594868611628,0.328201944961721
"Minnesota",27043,"Faribault County",5191,2531,7914,2660,0.655926206722264,0.319812989638615,0.336113217083649
"Minnesota",27045,"Fillmore County",7301,4551,12141,2750,0.601350794827444,0.374845564615765,0.22650523021168
"Minnesota",27047,"Freeborn County",9578,6889,16818,2689,0.569508859555238,0.409620644547509,0.15988821500773
"Minnesota",27049,"Goodhue County",16052,11806,28636,4246,0.560553149881268,0.412278251152396,0.148274898728873
"Minnesota",27051,"Grant County",2269,1300,3654,969,0.62096332785988,0.355774493705528,0.265188834154351
"Minnesota",27053,"Hennepin County",205973,532623,755969,-326650,0.272462230594112,0.704556668328992,-0.432094437734881
"Minnesota",27055,"Houston County",6334,4853,11440,1481,0.553671328671329,0.424213286713287,0.129458041958042
"Minnesota",27057,"Hubbard County",8202,4462,12965,3740,0.63262630158118,0.344157346702661,0.288468954878519
"Minnesota",27059,"Isanti County",16491,7138,24235,9353,0.680462141530844,0.294532700639571,0.385929440891273
"Minnesota",27061,"Itasca County",15239,10786,26561,4453,0.573735928617145,0.406084108279056,0.16765182033809
"Minnesota",27063,"Jackson County",3948,1745,5819,2203,0.678467090565389,0.299879704416566,0.378587386148823
"Minnesota",27065,"Kanabec County",6278,2774,9242,3504,0.679290196927072,0.300151482363125,0.379138714563947
"Minnesota",27067,"Kandiyohi County",14437,8440,23367,5997,0.61783712072581,0.361193135618607,0.256643985107202
"Minnesota",27069,"Kittson County",1546,1006,2639,540,0.58582796513831,0.381205001894657,0.204622963243653
"Minnesota",27071,"Koochiching County",4131,2659,6922,1472,0.596792834440913,0.384137532505056,0.212655301935857
"Minnesota",27073,"Lac qui Parle County",2528,1446,4040,1082,0.625742574257426,0.357920792079208,0.267821782178218
"Minnesota",27075,"Lake County",3393,3647,7202,-254,0.471119133574007,0.506387114690364,-0.0352679811163566
"Minnesota",27077,"Lake of the Woods County",1704,671,2408,1033,0.707641196013289,0.278654485049834,0.428986710963455
"Minnesota",27079,"Le Sueur County",10775,5672,16818,5103,0.640682601974075,0.337257700083244,0.303424901890831
"Minnesota",27081,"Lincoln County",2121,937,3115,1184,0.680898876404494,0.300802568218299,0.380096308186196
"Minnesota",27083,"Lyon County",7979,4634,12893,3345,0.618862948886993,0.359419840223377,0.259443108663616
"Minnesota",27085,"McLeod County",13986,6413,20933,7573,0.668131658147423,0.30635838150289,0.361773276644533
"Minnesota",27087,"Mahnomen County",1142,1112,2304,30,0.495659722222222,0.482638888888889,0.0130208333333333
"Minnesota",27089,"Marshall County",3721,1295,5113,2426,0.727752787013495,0.25327596323098,0.474476823782515
"Minnesota",27091,"Martin County",7480,3305,11009,4175,0.679444091198111,0.300208919974566,0.379235171223544
"Minnesota",27093,"Meeker County",9359,3867,13529,5492,0.691773227880848,0.285830438317688,0.40594278956316
"Minnesota",27095,"Mille Lacs County",9952,4404,14689,5548,0.677513785826128,0.299816188984955,0.377697596841174
"Minnesota",27097,"Morrison County",14821,4367,19558,10454,0.757797320789447,0.223284589426322,0.534512731363125
"Minnesota",27099,"Mower County",10025,8899,19345,1126,0.518221762729387,0.460015507883174,0.0582062548462135
"Minnesota",27101,"Murray County",3363,1449,4896,1914,0.686887254901961,0.295955882352941,0.39093137254902
"Minnesota",27103,"Nicollet County",9018,9622,19125,-604,0.471529411764706,0.503111111111111,-0.0315816993464052
"Minnesota",27105,"Nobles County",5600,2933,8715,2667,0.642570281124498,0.336546184738956,0.306024096385542
"Minnesota",27107,"Norman County",1953,1404,3441,549,0.567567567567568,0.408020924149956,0.159546643417611
"Minnesota",27109,"Olmsted County",39692,49491,91385,-9799,0.434338239317175,0.54156590250041,-0.107227663183236
"Minnesota",27111,"Otter Tail County",23800,11958,36399,11842,0.653864117146075,0.328525508942553,0.325338608203522
"Minnesota",27113,"Pennington County",4532,2568,7277,1964,0.622784114332829,0.352892675553113,0.269891438779717
"Minnesota",27115,"Pine County",10256,5419,16001,4837,0.64095994000375,0.338666333354165,0.302293606649584
"Minnesota",27117,"Pipestone County",3553,1306,4940,2247,0.719230769230769,0.264372469635628,0.454858299595142
"Minnesota",27119,"Polk County",9865,5439,15594,4426,0.632615108375016,0.34878799538284,0.283827112992176
"Minnesota",27121,"Pope County",4417,2477,7022,1940,0.629023070350328,0.352748504699516,0.276274565650812
"Minnesota",27123,"Ramsey County",77376,211620,295977,-134244,0.261425718890319,0.714987988931572,-0.453562270041253
"Minnesota",27125,"Red Lake County",1454,691,2196,763,0.662112932604736,0.314663023679417,0.347449908925319
"Minnesota",27127,"Redwood County",5771,2355,8284,3416,0.696644133268952,0.284282955094157,0.412361178174795
"Minnesota",27129,"Renville County",5467,2496,8128,2971,0.672613188976378,0.307086614173228,0.36552657480315
"Minnesota",27131,"Rice County",17464,17402,35686,62,0.489379588634198,0.487642212632405,0.00173737600179341
"Minnesota",27133,"Rock County",3583,1556,5240,2027,0.683778625954198,0.296946564885496,0.386832061068702
"Minnesota",27135,"Roseau County",6065,2188,8421,3877,0.720223251395321,0.2598266239164,0.460396627478922
"Minnesota",27137,"St. Louis County",49017,67704,119531,-18687,0.41007772042399,0.566413733675783,-0.156336013251792
"Minnesota",27139,"Scott County",45872,40040,87965,5832,0.521480134144262,0.455181037912806,0.0662990962314557
"Minnesota",27141,"Sherburne County",36222,18065,55612,18157,0.651334244407682,0.324839962598,0.326494281809681
"Minnesota",27143,"Sibley County",5864,2417,8452,3447,0.69380028395646,0.285967818267866,0.407832465688594
"Minnesota",27145,"Stearns County",50959,31879,84835,19080,0.600683680084871,0.375776507337773,0.224907172747097
"Minnesota",27147,"Steele County",12656,7917,21128,4739,0.599015524422567,0.374716016660356,0.224299507762211
"Minnesota",27149,"Stevens County",3044,1922,5085,1122,0.598623402163225,0.377974434611603,0.220648967551622
"Minnesota",27151,"Swift County",3316,1784,5193,1532,0.638551896784132,0.343539379934527,0.295012516849605
"Minnesota",27153,"Todd County",9753,3286,13257,6467,0.735686806969903,0.247869050313042,0.487817756656861
"Minnesota",27155,"Traverse County",1172,661,1864,511,0.628755364806867,0.354613733905579,0.274141630901288
"Minnesota",27157,"Wabasha County",8153,4696,13123,3457,0.621275622952069,0.357845004953136,0.263430617998933
"Minnesota",27159,"Wadena County",5520,2023,7677,3497,0.719030871434154,0.26351439364335,0.455516477790804
"Minnesota",27161,"Waseca County",6624,3496,10389,3128,0.637597458850708,0.336509769948985,0.301087688901723
"Minnesota",27163,"Washington County",73764,89165,166786,-15401,0.442267336587004,0.5346072212296,-0.0923398846425959
"Minnesota",27165,"Watonwan County",3103,1987,5201,1116,0.596616035377812,0.382041915016343,0.214574120361469
"Minnesota",27167,"Wilkin County",2328,1026,3430,1302,0.678717201166181,0.299125364431487,0.379591836734694
"Minnesota",27169,"Winona County",13227,13333,27173,-106,0.486769955470504,0.490670886541788,-0.00390093107128398
"Minnesota",27171,"Wright County",51973,28430,82426,23543,0.630541334045083,0.344915439303133,0.28562589474195
"Minnesota",27173,"Yellow Medicine County",3734,1688,5528,2046,0.675470332850941,0.305354558610709,0.370115774240232
"Mississippi",28001,"Adams County",5696,7917,13759,-2221,0.413983574387674,0.57540518933062,-0.161421614942946
"Mississippi",28003,"Alcorn County",12818,2782,15811,10036,0.810701410410474,0.175953450129657,0.634747960280817
"Mississippi",28005,"Amite County",4503,2620,7207,1883,0.624809213264881,0.363535451644235,0.261273761620647
"Mississippi",28007,"Attala County",5178,3542,8832,1636,0.586277173913043,0.401041666666667,0.185235507246377
"Mississippi",28009,"Benton County",2570,1679,4292,891,0.59878844361603,0.391192917054986,0.207595526561044
"Mississippi",28011,"Bolivar County",4671,8904,13755,-4233,0.33958560523446,0.647328244274809,-0.307742639040349
"Mississippi",28013,"Calhoun County",4625,1902,6595,2723,0.701288855193328,0.288400303260046,0.412888551933283
"Mississippi",28015,"Carroll County",3924,1729,5705,2195,0.687817703768624,0.303067484662577,0.384750219106047
"Mississippi",28017,"Chickasaw County",4175,3810,8148,365,0.512395679921453,0.46759941089838,0.0447962690230731
"Mississippi",28019,"Choctaw County",3001,1185,4225,1816,0.710295857988166,0.280473372781065,0.4298224852071
"Mississippi",28021,"Claiborne County",603,3772,4453,-3169,0.135414327419717,0.847069391421514,-0.711655064001797
"Mississippi",28023,"Clarke County",5417,2838,8347,2579,0.648975679884989,0.340002396070444,0.308973283814544
"Mississippi",28025,"Clay County",4181,5844,10206,-1663,0.409660983735058,0.572604350382128,-0.16294336664707
"Mississippi",28027,"Coahoma County",2375,6020,8507,-3645,0.279181850240978,0.707652521452921,-0.428470671211943
"Mississippi",28029,"Copiah County",6250,6470,12897,-220,0.484608823757463,0.501667054353726,-0.0170582305962627
"Mississippi",28031,"Covington County",5854,3416,9371,2438,0.624693202433038,0.364528865649344,0.260164336783694
"Mississippi",28033,"DeSoto County",46462,28265,76248,18197,0.609353687965586,0.370698247822894,0.238655440142692
"Mississippi",28035,"Forrest County",17290,13755,31725,3535,0.544996059889677,0.433569739952719,0.111426319936958
"Mississippi",28037,"Franklin County",2923,1480,4464,1443,0.654793906810036,0.331541218637993,0.323252688172043
"Mississippi",28039,"George County",9713,1218,11064,8495,0.877892263195951,0.110086767895879,0.767805495300072
"Mississippi",28041,"Greene County",4794,966,5816,3828,0.824277854195323,0.166093535075653,0.65818431911967
"Mississippi",28043,"Grenada County",6081,4734,10919,1347,0.556919131788625,0.433556186463962,0.123362945324663
"Mississippi",28045,"Hancock County",16132,4504,20957,11628,0.769766665076108,0.214916257097867,0.554850407978241
"Mississippi",28047,"Harrison County",46822,27728,75865,19094,0.617175245501878,0.365491333289396,0.251683912212483
"Mississippi",28049,"Hinds County",25141,73550,100191,-48409,0.250930722320368,0.734097873062451,-0.483167150742083
"Mississippi",28051,"Holmes County",1369,6588,8115,-5219,0.168699938385705,0.811829944547135,-0.64313000616143
"Mississippi",28053,"Humphreys County",1118,3016,4189,-1898,0.266889472427787,0.719980902363333,-0.453091429935546
"Mississippi",28055,"Issaquena County",308,355,676,-47,0.455621301775148,0.525147928994083,-0.0695266272189349
"Mississippi",28057,"Itawamba County",9438,1249,10826,8189,0.871790134860521,0.115370404581563,0.756419730278958
"Mississippi",28059,"Jackson County",36295,17375,54623,18920,0.664463687457664,0.318089449499295,0.346374237958369
"Mississippi",28061,"Jasper County",4302,4341,8742,-39,0.492107069320522,0.496568291008922,-0.00446122168840085
"Mississippi",28063,"Jefferson County",531,3327,3911,-2796,0.13577090258246,0.850677576067502,-0.714906673485042
"Mississippi",28065,"Jefferson Davis County",2534,3599,6213,-1065,0.407854498631901,0.579269274102688,-0.171414775470787
"Mississippi",28067,"Jones County",21226,8517,30091,12709,0.705393639294141,0.283041440962414,0.422352198331727
"Mississippi",28069,"Kemper County",1787,2887,4732,-1100,0.377641589180051,0.610101437024514,-0.232459847844463
"Mississippi",28071,"Lafayette County",12949,10070,23481,2879,0.551467143648056,0.428857374047102,0.122609769600954
"Mississippi",28073,"Lamar County",20704,7340,28526,13364,0.725794012479843,0.25730912150319,0.468484890976653
"Mississippi",28075,"Lauderdale County",17967,12960,31266,5007,0.574649779312992,0.414507772020725,0.160142007292266
"Mississippi",28077,"Lawrence County",4285,2260,6617,2025,0.647574429499773,0.341544506573976,0.306029922925797
"Mississippi",28079,"Leake County",5228,3897,9204,1331,0.568013906996958,0.423402868318123,0.144611038678835
"Mississippi",28081,"Lee County",24207,12189,37003,12018,0.65419020079453,0.329405723860228,0.324784476934303
"Mississippi",28083,"Leflore County",3129,7648,10893,-4519,0.287248691820435,0.702102267511246,-0.414853575690811
"Mississippi",28085,"Lincoln County",11596,5040,16818,6556,0.689499345938875,0.299678915447735,0.38982043049114
"Mississippi",28087,"Lowndes County",13800,13087,27273,713,0.5059949400506,0.479851868147985,0.0261430719026143
"Mississippi",28089,"Madison County",31091,24440,56335,6651,0.551894914351646,0.433833318540872,0.118061595810775
"Mississippi",28091,"Marion County",8273,3787,12194,4486,0.678448417254387,0.310562571756602,0.367885845497786
"Mississippi",28093,"Marshall County",7566,8057,15830,-491,0.477953253316488,0.50897030953885,-0.0310170562223626
"Mississippi",28095,"Monroe County",11177,5874,17279,5303,0.646854563342786,0.339950228601192,0.306904334741594
"Mississippi",28097,"Montgomery County",2917,2121,5078,796,0.574438755415518,0.417684127609295,0.156754627806223
"Mississippi",28099,"Neshoba County",8320,3260,11720,5060,0.709897610921502,0.278156996587031,0.431740614334471
"Mississippi",28101,"Newton County",6997,3075,10189,3922,0.686720973598979,0.301796054568652,0.384924919030327
"Mississippi",28103,"Noxubee County",1240,4040,5341,-2800,0.232166260999813,0.756412656805842,-0.524246395806029
"Mississippi",28105,"Oktibbeha County",9004,10299,19812,-1295,0.454472037149202,0.519836462749849,-0.0653644256006461
"Mississippi",28107,"Panola County",8060,7403,15635,657,0.515510073552926,0.473488967061081,0.0420211064918452
"Mississippi",28109,"Pearl River County",19595,4148,24056,15447,0.814557698703026,0.172430994346525,0.642126704356502
"Mississippi",28111,"Perry County",4500,1362,5922,3138,0.759878419452888,0.229989868287741,0.529888551165147
"Mississippi",28113,"Pike County",8479,8646,17360,-167,0.488421658986175,0.498041474654378,-0.00961981566820275
"Mississippi",28115,"Pontotoc County",11550,2614,14377,8936,0.80336648814078,0.181818181818182,0.621548306322599
"Mississippi",28117,"Prentiss County",8370,2153,10661,6217,0.785104586811744,0.201951036488134,0.58315355032361
"Mississippi",28119,"Quitman County",1026,2150,3229,-1124,0.317745432022298,0.665840817590585,-0.348095385568287
"Mississippi",28121,"Rankin County",50895,18847,70655,32048,0.72033118675253,0.266746868586795,0.453584318165735
"Mississippi",28123,"Scott County",6285,4330,10744,1955,0.584977661950856,0.403015636634401,0.181962025316456
"Mississippi",28125,"Sharkey County",688,1465,2183,-777,0.315162620247366,0.671094823637197,-0.35593220338983
"Mississippi",28127,"Simpson County",7635,4037,11820,3598,0.645939086294416,0.341539763113367,0.304399323181049
"Mississippi",28129,"Smith County",6458,1791,8327,4667,0.775549417557344,0.215083463432208,0.560465954125135
"Mississippi",28131,"Stone County",5964,1802,7878,4162,0.757044935262757,0.228738258441229,0.528306676821528
"Mississippi",28133,"Sunflower County",2799,6781,9683,-3982,0.289063306826397,0.700299493958484,-0.411236187132087
"Mississippi",28135,"Tallahatchie County",2488,3105,5691,-617,0.43718151467229,0.545598313125988,-0.108416798453699
"Mississippi",28137,"Tate County",8707,4183,13101,4524,0.664605755285856,0.319288603923365,0.345317151362491
"Mississippi",28139,"Tippah County",8054,1937,10102,6117,0.797267867748961,0.191744209067511,0.605523658681449
"Mississippi",28141,"Tishomingo County",7933,1059,9147,6874,0.867278889253307,0.115775664152181,0.751503225101126
"Mississippi",28143,"Tunica County",926,2580,3565,-1654,0.259747545582048,0.723702664796634,-0.463955119214586
"Mississippi",28145,"Union County",10373,2160,12683,8213,0.81786643538595,0.170306709768982,0.647559725616968
"Mississippi",28147,"Walthall County",4220,2835,7122,1385,0.592530188149396,0.398062342038753,0.194467846110643
"Mississippi",28149,"Warren County",10365,10442,21056,-77,0.492258738601824,0.495915653495441,-0.00365691489361702
"Mississippi",28151,"Washington County",5300,12503,18025,-7203,0.294036061026352,0.693647711511789,-0.399611650485437
"Mississippi",28153,"Wayne County",6307,3624,10065,2683,0.626626924987581,0.360059612518629,0.266567312468952
"Mississippi",28155,"Webster County",4291,1043,5402,3248,0.794335431321733,0.193076638282118,0.601258793039615
"Mississippi",28157,"Wilkinson County",1324,2749,4130,-1425,0.320581113801453,0.665617433414044,-0.345036319612591
"Mississippi",28159,"Winston County",5112,4040,9244,1072,0.553007356122891,0.437040242319342,0.115967113803548
"Mississippi",28161,"Yalobusha County",3671,2785,6538,886,0.561486693178342,0.425971245029061,0.135515448149281
"Mississippi",28163,"Yazoo County",4832,5496,10441,-664,0.462790920409922,0.52638636145963,-0.0635954410497079
"Missouri",29001,"Adair County",6413,3710,10336,2703,0.620452786377709,0.358939628482972,0.261513157894737
"Missouri",29003,"Andrew County",7255,2351,9752,4904,0.743949958982773,0.241078753076292,0.502871205906481
"Missouri",29005,"Atchison County",2199,564,2814,1635,0.781449893390192,0.200426439232409,0.581023454157783
"Missouri",29007,"Audrain County",7732,2704,10656,5028,0.725600600600601,0.253753753753754,0.471846846846847
"Missouri",29009,"Barry County",12425,2948,15598,9477,0.796576484164636,0.188998589562764,0.607577894601872
"Missouri",29011,"Barton County",5168,844,6077,4324,0.850419614941583,0.138884317920026,0.711535297021557
"Missouri",29013,"Bates County",6597,1672,8416,4925,0.783864068441065,0.198669201520913,0.585194866920152
"Missouri",29015,"Benton County",8109,2180,10476,5929,0.77405498281787,0.208094692630775,0.565960290187094
"Missouri",29017,"Bollinger County",5167,750,5983,4417,0.863613571786729,0.125355172990139,0.73825839879659
"Missouri",29019,"Boone County",38646,50064,91168,-11418,0.423898736398736,0.549140049140049,-0.125241312741313
"Missouri",29021,"Buchanan County",22450,13445,36598,9005,0.613421498442538,0.367369801628504,0.246051696814033
"Missouri",29023,"Butler County",14602,3301,18141,11301,0.804917038751998,0.18196350807563,0.622953530676368
"Missouri",29025,"Caldwell County",3725,897,4682,2828,0.795600170867151,0.19158479282358,0.604015378043571
"Missouri",29027,"Callaway County",14815,5870,21144,8945,0.700671585319712,0.277620128641695,0.423051456678017
"Missouri",29029,"Camden County",18850,5652,24812,13198,0.759713042076415,0.227793003385459,0.531920038690956
"Missouri",29031,"Cape Girardeau County",28907,10760,40328,18147,0.716797262447927,0.266812140448324,0.449985121999603
"Missouri",29033,"Carroll County",3706,786,4532,2920,0.817740511915269,0.173433362753751,0.644307149161518
"Missouri",29035,"Carter County",2451,418,2897,2033,0.846047635484985,0.144287193648602,0.701760441836383
"Missouri",29037,"Cass County",37197,19052,57408,18145,0.647941053511706,0.331870122630992,0.316070930880714
"Missouri",29039,"Cedar County",5788,1145,7044,4643,0.821692220329358,0.162549687677456,0.659142532651902
"Missouri",29041,"Chariton County",3111,916,4077,2195,0.763061074319352,0.22467500613196,0.538386068187393
"Missouri",29043,"Christian County",34920,11131,46839,23789,0.745532569013002,0.237643843805376,0.507888725207626
"Missouri",29045,"Clark County",2672,678,3394,1994,0.787271655863288,0.199764289923394,0.587507365939894
"Missouri",29047,"Clay County",64605,59400,126569,5205,0.51043304442636,0.469309230538283,0.0411238138880768
"Missouri",29049,"Clinton County",7799,2896,10888,4903,0.716293166789126,0.265980896399706,0.45031227038942
"Missouri",29051,"Cole County",26086,12694,39529,13392,0.659920564648739,0.321131321308406,0.338789243340332
"Missouri",29053,"Cooper County",6272,2249,8693,4023,0.721500057517543,0.258713907741861,0.462786149775682
"Missouri",29055,"Crawford County",8725,2113,10973,6612,0.795133509523376,0.192563565114372,0.602569944409004
"Missouri",29057,"Dade County",3414,656,4119,2758,0.82884195193008,0.159261956785628,0.669579995144453
"Missouri",29059,"Dallas County",6619,1380,8104,5239,0.816757156959526,0.170286278381046,0.64647087857848
"Missouri",29061,"Daviess County",3102,746,3911,2356,0.793147532600358,0.190744055228842,0.602403477371516
"Missouri",29063,"DeKalb County",3828,930,4843,2898,0.790419161676647,0.192029733636176,0.598389428040471
"Missouri",29065,"Dent County",5987,1056,7142,4931,0.83828059367124,0.147857742929151,0.690422850742089
"Missouri",29067,"Douglas County",5898,1016,7000,4882,0.842571428571429,0.145142857142857,0.697428571428571
"Missouri",29069,"Dunklin County",8135,2200,10419,5935,0.780785104136673,0.211152701794798,0.569632402341875
"Missouri",29071,"Franklin County",38058,14569,53685,23489,0.708913104219056,0.27137934246065,0.437533761758406
"Missouri",29073,"Gasconade County",6222,1601,7923,4621,0.78530859522908,0.202069923008961,0.583238672220119
"Missouri",29075,"Gentry County",2581,613,3237,1968,0.797343219029966,0.189372876119864,0.607970342910102
"Missouri",29077,"Greene County",83630,55068,141800,28562,0.589774330042313,0.388349788434415,0.201424541607898
"Missouri",29079,"Grundy County",3585,799,4437,2786,0.807978363759297,0.18007662835249,0.627901735406806
"Missouri",29081,"Harrison County",3198,597,3826,2601,0.835859905906952,0.156037637219028,0.679822268687925
"Missouri",29083,"Henry County",8027,2619,10788,5408,0.744067482387838,0.242769744160178,0.50129773822766
"Missouri",29085,"Hickory County",3966,1056,5080,2910,0.780708661417323,0.207874015748031,0.572834645669291
"Missouri",29087,"Holt County",1976,338,2343,1638,0.843363209560393,0.144259496372172,0.69910371318822
"Missouri",29089,"Howard County",3553,1413,5092,2140,0.697761194029851,0.277494108405342,0.420267085624509
"Missouri",29091,"Howell County",15181,3218,18650,11963,0.813994638069705,0.17254691689008,0.641447721179625
"Missouri",29093,"Iron County",3596,945,4592,2651,0.783101045296167,0.205792682926829,0.577308362369338
"Missouri",29095,"Jackson County",126535,199842,333063,-73307,0.37991310953183,0.600012610226894,-0.220099500695064
"Missouri",29097,"Jasper County",37728,13549,52352,24179,0.720660146699266,0.258805776283619,0.461854370415648
"Missouri",29099,"Jefferson County",77046,37523,116688,39523,0.660273549979432,0.321566913478678,0.338706636500754
"Missouri",29101,"Johnson County",15489,6974,23123,8515,0.669852527786187,0.3016044630887,0.368248064697487
"Missouri",29103,"Knox County",1486,340,1854,1146,0.80151024811219,0.183387270765912,0.618122977346278
"Missouri",29105,"Laclede County",13762,2780,16793,10982,0.819508128386828,0.165545167629369,0.653962960757458
"Missouri",29107,"Lafayette County",12273,4472,17055,7801,0.719613016710642,0.262210495455878,0.457402521254764
"Missouri",29109,"Lawrence County",14426,3214,17905,11212,0.805696732756213,0.17950293214186,0.626193800614353
"Missouri",29111,"Lewis County",3553,984,4609,2569,0.770883054892601,0.213495335213712,0.557387719678889
"Missouri",29113,"Lincoln County",21848,6607,29018,15241,0.752911985664071,0.227686263698394,0.525225721965677
"Missouri",29115,"Linn County",4363,1275,5726,3088,0.761962975899406,0.222668529514495,0.539294446384911
"Missouri",29117,"Livingston County",5267,1410,6758,3857,0.779372595442439,0.20864160994377,0.570730985498668
"Missouri",29119,"McDonald County",7465,1439,9053,6026,0.824588534187562,0.158952833314923,0.665635700872639
"Missouri",29121,"Macon County",6076,1662,7836,4414,0.775395610005105,0.212098009188361,0.563297600816743
"Missouri",29123,"Madison County",4584,1019,5676,3565,0.807610993657505,0.179527836504581,0.628083157152925
"Missouri",29125,"Maries County",3892,814,4771,3078,0.815761894780968,0.170614127017397,0.645147767763572
"Missouri",29127,"Marion County",9915,3202,13348,6713,0.742807911297573,0.239886125262212,0.502921786035361
"Missouri",29129,"Mercer County",1541,222,1779,1319,0.866216975829117,0.124789207419899,0.741427768409219
"Missouri",29131,"Miller County",10176,2038,12382,8138,0.821838152156356,0.164593765142949,0.657244387013407
"Missouri",29133,"Mississippi County",3537,1178,4756,2359,0.743692178301093,0.247687132043734,0.496005046257359
"Missouri",29135,"Moniteau County",5744,1308,7157,4436,0.802570909598994,0.182758138885008,0.619812770713986
"Missouri",29137,"Monroe County",3477,936,4483,2541,0.775596698639304,0.208788757528441,0.566807941110863
"Missouri",29139,"Montgomery County",4465,1208,5772,3257,0.773562023562024,0.209286209286209,0.564275814275814
"Missouri",29141,"Morgan County",7442,1924,9487,5518,0.784441867819121,0.202803836829345,0.581638030989776
"Missouri",29143,"New Madrid County",5447,1748,7250,3699,0.751310344827586,0.241103448275862,0.510206896551724
"Missouri",29145,"Newton County",22120,5818,28405,16302,0.778736138003873,0.204823094525612,0.573913043478261
"Missouri",29147,"Nodaway County",6865,2853,9893,4012,0.693924997472961,0.288385727281917,0.405539270191044
"Missouri",29149,"Oregon County",3847,823,4739,3024,0.811774635999156,0.173665330238447,0.638109305760709
"Missouri",29151,"Osage County",6425,1037,7539,5388,0.852235044435601,0.13755139938984,0.714683645045762
"Missouri",29153,"Ozark County",4064,752,4864,3312,0.835526315789474,0.154605263157895,0.680921052631579
"Missouri",29155,"Pemiscot County",4120,1560,5735,2560,0.718395815170009,0.272013949433304,0.446381865736704
"Missouri",29157,"Perry County",7657,1664,9447,5993,0.810521858791151,0.176140573727109,0.634381285064042
"Missouri",29159,"Pettis County",13854,4783,19097,9071,0.725454259831387,0.250458187149814,0.474996072681573
"Missouri",29161,"Phelps County",13480,5637,19568,7843,0.688879803761243,0.288072363041701,0.400807440719542
"Missouri",29163,"Pike County",5863,1717,7695,4146,0.761923326835607,0.223131903833658,0.538791423001949
"Missouri",29165,"Platte County",28917,27179,57270,1738,0.504924044002095,0.474576567138118,0.0303474768639777
"Missouri",29167,"Polk County",11850,2885,15064,8965,0.786643653744025,0.19151619755709,0.595127456186936
"Missouri",29169,"Pulaski County",10329,3740,14414,6589,0.716594977105592,0.259469959761343,0.457125017344249
"Missouri",29171,"Putnam County",1984,361,2361,1623,0.840321897501059,0.152901313002965,0.687420584498094
"Missouri",29173,"Ralls County",4396,1205,5662,3191,0.776404097492052,0.212822324267043,0.563581773225009
"Missouri",29175,"Randolph County",8018,2485,10744,5533,0.746276991809382,0.231291883842144,0.514985107967238
"Missouri",29177,"Ray County",8345,3109,11649,5236,0.716370503905915,0.266889861790712,0.449480642115203
"Missouri",29179,"Reynolds County",2733,529,3298,2204,0.828684050939964,0.160400242571255,0.668283808368708
"Missouri",29181,"Ripley County",4839,833,5717,4006,0.846422949099178,0.145705789749869,0.700717159349309
"Missouri",29183,"St. Charles County",128389,89530,222017,38859,0.578284545778026,0.403257408216488,0.175027137561538
"Missouri",29185,"St. Clair County",3932,988,4974,2944,0.790510655408122,0.198632891033374,0.591877764374749
"Missouri",29186,"Ste. Genevieve County",6630,2713,9484,3917,0.699072121467735,0.286060733867566,0.413011387600169
"Missouri",29187,"St. Francois County",20511,7044,28001,13467,0.732509553230242,0.251562444198421,0.48094710903182
"Missouri",29189,"St. Louis County",199493,328151,536446,-128658,0.371878996208379,0.611713014916692,-0.239834018708314
"Missouri",29195,"Saline County",6451,2904,9519,3547,0.677697237104738,0.305074062401513,0.372623174703225
"Missouri",29197,"Schuyler County",1606,373,2003,1233,0.801797304043934,0.186220668996505,0.615576635047429
"Missouri",29199,"Scotland County",1560,388,1984,1172,0.786290322580645,0.195564516129032,0.590725806451613
"Missouri",29201,"Scott County",13769,3753,17719,10016,0.777075455725492,0.211806535357526,0.565268920367967
"Missouri",29203,"Shannon County",3165,706,3906,2459,0.810291858678955,0.180747567844342,0.629544290834613
"Missouri",29205,"Shelby County",2700,592,3350,2108,0.805970149253731,0.176716417910448,0.629253731343284
"Missouri",29207,"Stoddard County",11484,1819,13426,9665,0.855355280798451,0.135483390436467,0.719871890361984
"Missouri",29209,"Stone County",14800,3506,18483,11294,0.800735811286047,0.18968782124114,0.611047990044906
"Missouri",29211,"Sullivan County",1974,478,2471,1496,0.798866855524079,0.193443949817887,0.605422905706192
"Missouri",29213,"Taney County",20508,5339,26288,15169,0.780127814972611,0.203096469872185,0.577031345100426
"Missouri",29215,"Texas County",9478,1716,11315,7762,0.837649138311975,0.151657092355281,0.685992045956695
"Missouri",29217,"Vernon County",7155,1903,9185,5252,0.778987479586282,0.207185628742515,0.571801850843767
"Missouri",29219,"Warren County",13222,4769,18375,8453,0.71956462585034,0.259537414965986,0.460027210884354
"Missouri",29221,"Washington County",8047,1804,9976,6243,0.806635926222935,0.180834001603849,0.625801924619086
"Missouri",29223,"Wayne County",4987,845,5878,4142,0.848417829193603,0.143756379720994,0.70466144947261
"Missouri",29225,"Webster County",14880,3573,18779,11307,0.79237446083391,0.190265722349433,0.602108738484477
"Missouri",29227,"Worth County",877,215,1107,662,0.79223125564589,0.194218608852755,0.598012646793135
"Missouri",29229,"Wright County",7453,1168,8739,6285,0.852843574779723,0.133653736125415,0.719189838654308
"Missouri",29510,"St. Louis city",21474,110089,133867,-88615,0.160412947178916,0.822375940298953,-0.661962993120037
"Montana",30001,"Beaverhead County",3923,1608,5661,2315,0.692987104751811,0.28404875463699,0.408938350114821
"Montana",30003,"Big Horn County",2207,2491,4784,-284,0.461329431438127,0.52069397993311,-0.0593645484949833
"Montana",30005,"Blaine County",1469,1589,3117,-120,0.471286493423163,0.509785049727302,-0.0384985563041386
"Montana",30007,"Broadwater County",3173,835,4097,2338,0.774469123749085,0.203807664144496,0.570661459604589
"Montana",30009,"Carbon County",4468,2421,7101,2047,0.629207153921983,0.340937896070976,0.288269257851007
"Montana",30011,"Carter County",775,74,864,701,0.896990740740741,0.0856481481481482,0.811342592592593
"Montana",30013,"Cascade County",23315,15456,39885,7859,0.584555597342359,0.387514103046258,0.197041494296101
"Montana",30015,"Chouteau County",1891,991,2974,900,0.635843981170141,0.333221250840619,0.302622730329522
"Montana",30017,"Custer County",4205,1514,5883,2691,0.714771375148734,0.257351691313955,0.457419683834778
"Montana",30019,"Daniels County",799,195,1014,604,0.787968441814596,0.192307692307692,0.595660749506903
"Montana",30021,"Dawson County",3758,962,4837,2796,0.77692784783957,0.198883605540624,0.578044242298946
"Montana",30023,"Deer Lodge County",2186,2562,4891,-376,0.446943365364956,0.523819259865058,-0.0768758945001022
"Montana",30025,"Fallon County",1375,172,1575,1203,0.873015873015873,0.109206349206349,0.763809523809524
"Montana",30027,"Fergus County",4869,1496,6531,3373,0.74552135966927,0.229061399479406,0.516459960189864
"Montana",30029,"Flathead County",38321,20274,60258,18047,0.635948753692456,0.336453251020611,0.299495502671844
"Montana",30031,"Gallatin County",31696,37044,71507,-5348,0.443257303480778,0.518047184191757,-0.0747898807109793
"Montana",30033,"Garfield County",764,41,813,723,0.939729397293973,0.050430504305043,0.88929889298893
"Montana",30035,"Glacier County",1884,3610,5639,-1726,0.334101791097712,0.640184429863451,-0.306082638765739
"Montana",30037,"Golden Valley County",414,78,503,336,0.823061630218688,0.15506958250497,0.667992047713718
"Montana",30039,"Granite County",1419,638,2102,781,0.675071360608944,0.303520456707897,0.371550903901047
"Montana",30041,"Hill County",3957,2981,7182,976,0.550960735171262,0.415065441381231,0.135895293790031
"Montana",30043,"Jefferson County",5345,2625,8191,2720,0.652545476742766,0.320473690636064,0.332071786106702
"Montana",30045,"Judith Basin County",1040,275,1344,765,0.773809523809524,0.204613095238095,0.569196428571429
"Montana",30047,"Lake County",9322,6916,16626,2406,0.560688078912547,0.415974978948635,0.144713099963912
"Montana",30049,"Lewis and Clark County",21409,19743,42485,1666,0.503919030245969,0.464705190067082,0.0392138401788867
"Montana",30051,"Liberty County",821,249,1083,572,0.758079409048938,0.229916897506925,0.528162511542013
"Montana",30053,"Lincoln County",8672,2835,11747,5837,0.738231037711756,0.241338214012088,0.496892823699668
"Montana",30055,"McCone County",956,155,1128,801,0.847517730496454,0.13741134751773,0.710106382978723
"Montana",30057,"Madison County",4191,1771,6113,2420,0.685588090953705,0.289710453132668,0.395877637821037
"Montana",30059,"Meagher County",833,258,1110,575,0.75045045045045,0.232432432432432,0.518018018018018
"Montana",30061,"Mineral County",1828,686,2563,1142,0.713226687475614,0.267655091689426,0.445571595786188
"Montana",30063,"Missoula County",26347,43357,71986,-17010,0.366001722557164,0.602297668991193,-0.236295946434029
"Montana",30065,"Musselshell County",2423,413,2881,2010,0.841027421034363,0.143353002429712,0.697674418604651
"Montana",30067,"Park County",6025,5280,11618,745,0.518591840247891,0.454467206059563,0.0641246341883284
"Montana",30069,"Petroleum County",298,39,351,259,0.849002849002849,0.111111111111111,0.737891737891738
"Montana",30071,"Phillips County",1936,416,2386,1520,0.811399832355407,0.174350377200335,0.637049455155071
"Montana",30073,"Pondera County",2031,903,2995,1128,0.678130217028381,0.301502504173623,0.376627712854758
"Montana",30075,"Powder River County",970,154,1136,816,0.85387323943662,0.13556338028169,0.71830985915493
"Montana",30077,"Powell County",2355,752,3195,1603,0.737089201877934,0.235367762128325,0.501721439749609
"Montana",30079,"Prairie County",603,126,744,477,0.810483870967742,0.169354838709677,0.641129032258065
"Montana",30081,"Ravalli County",19114,8763,28507,10351,0.670501981969341,0.307398182902445,0.363103799066896
"Montana",30083,"Richland County",4800,875,5798,3925,0.827871679889617,0.150914108313211,0.676957571576406
"Montana",30085,"Roosevelt County",1996,1910,4028,86,0.495531281032771,0.474180734856008,0.0213505461767627
"Montana",30087,"Rosebud County",2486,1199,3784,1287,0.656976744186046,0.316860465116279,0.340116279069767
"Montana",30089,"Sanders County",5660,1820,7652,3840,0.739675901725039,0.23784631468897,0.501829587036069
"Montana",30091,"Sheridan County",1403,574,2030,829,0.691133004926108,0.282758620689655,0.408374384236453
"Montana",30093,"Silver Bow County",7745,10392,18827,-2647,0.411377277314495,0.551973229935731,-0.140595952621235
"Montana",30095,"Stillwater County",4462,1156,5741,3306,0.777216512802648,0.201358648319108,0.57585786448354
"Montana",30097,"Sweet Grass County",1840,549,2446,1291,0.752248569092396,0.224448078495503,0.527800490596893
"Montana",30099,"Teton County",2608,1007,3695,1601,0.705818673883627,0.272530446549391,0.433288227334235
"Montana",30101,"Toole County",1596,467,2123,1129,0.751766368346679,0.219971738106453,0.531794630240226
"Montana",30103,"Treasure County",373,78,460,295,0.810869565217391,0.169565217391304,0.641304347826087
"Montana",30105,"Valley County",3135,1030,4272,2105,0.733848314606742,0.241104868913858,0.492743445692884
"Montana",30107,"Wheatland County",823,225,1068,598,0.77059925093633,0.210674157303371,0.559925093632959
"Montana",30109,"Wibaux County",516,77,598,439,0.862876254180602,0.12876254180602,0.734113712374582
"Montana",30111,"Yellowstone County",50772,30679,83821,20093,0.605719330478042,0.366006132114864,0.239713198363179
"Nebraska",31001,"Adams County",10085,4213,14653,5872,0.688254964853614,0.287517914420255,0.400737050433358
"Nebraska",31003,"Antelope County",3093,452,3583,2641,0.863243092380687,0.126151269885571,0.737091822495116
"Nebraska",31005,"Arthur County",260,21,285,239,0.912280701754386,0.0736842105263158,0.83859649122807
"Nebraska",31007,"Banner County",362,43,411,319,0.880778588807786,0.104622871046229,0.776155717761557
"Nebraska",31009,"Blaine County",280,35,317,245,0.883280757097792,0.110410094637224,0.772870662460568
"Nebraska",31011,"Boone County",2653,499,3226,2154,0.82238065716057,0.154680719156851,0.66769993800372
"Nebraska",31013,"Box Butte County",4002,1051,5200,2951,0.769615384615385,0.202115384615385,0.5675
"Nebraska",31015,"Boyd County",1010,135,1155,875,0.874458874458874,0.116883116883117,0.757575757575758
"Nebraska",31017,"Brown County",1470,191,1684,1279,0.8729216152019,0.113420427553444,0.759501187648456
"Nebraska",31019,"Buffalo County",16640,6350,23711,10290,0.701783982118004,0.267808190291426,0.433975791826578
"Nebraska",31021,"Burt County",2580,1063,3739,1517,0.690024070607114,0.284300615137737,0.405723455469377
"Nebraska",31023,"Butler County",3542,873,4518,2669,0.783975210270031,0.193227091633466,0.590748118636565
"Nebraska",31025,"Cass County",10121,4737,15326,5384,0.660381051807386,0.309082604723998,0.351298447083388
"Nebraska",31027,"Cedar County",4174,725,5015,3449,0.832303090727816,0.14456630109671,0.687736789631107
"Nebraska",31029,"Chase County",1740,226,2000,1514,0.87,0.113,0.757
"Nebraska",31031,"Cherry County",2844,373,3269,2471,0.869990822881615,0.114102171918018,0.755888650963597
"Nebraska",31033,"Cheyenne County",3813,855,4776,2958,0.798366834170854,0.179020100502513,0.619346733668342
"Nebraska",31035,"Clay County",2848,632,3570,2216,0.797759103641457,0.17703081232493,0.620728291316527
"Nebraska",31037,"Colfax County",2636,1025,3726,1611,0.707461084272679,0.275093934514224,0.432367149758454
"Nebraska",31039,"Cuming County",3507,870,4459,2637,0.786499215070644,0.195111011437542,0.591388203633102
"Nebraska",31041,"Custer County",5090,786,6010,4304,0.846921797004992,0.130782029950083,0.716139767054909
"Nebraska",31043,"Dakota County",3926,2744,6817,1182,0.575913158280769,0.402523104004694,0.173390054276074
"Nebraska",31045,"Dawes County",2931,1082,4151,1849,0.706094916887497,0.260660081907974,0.445434834979523
"Nebraska",31047,"Dawson County",6524,2497,9191,4027,0.70982482863671,0.271678816233272,0.438146012403438
"Nebraska",31049,"Deuel County",871,141,1034,730,0.842359767891683,0.136363636363636,0.705996131528046
"Nebraska",31051,"Dixon County",2335,651,3094,1684,0.754686489980608,0.210407239819005,0.544279250161603
"Nebraska",31053,"Dodge County",10984,5544,16938,5440,0.648482701617664,0.32731137088204,0.321171330735624
"Nebraska",31055,"Douglas County",119159,150350,276540,-31191,0.430892456787445,0.5436826498879,-0.112790193100456
"Nebraska",31057,"Dundy County",883,105,1003,778,0.880358923230309,0.10468594217348,0.77567298105683
"Nebraska",31059,"Fillmore County",2359,693,3148,1666,0.749364675984752,0.220139771283354,0.529224904701398
"Nebraska",31061,"Franklin County",1437,276,1728,1161,0.831597222222222,0.159722222222222,0.671875
"Nebraska",31063,"Frontier County",1229,189,1446,1040,0.849930843706777,0.130705394190871,0.719225449515906
"Nebraska",31065,"Furnas County",2163,399,2602,1764,0.831283627978478,0.153343581860108,0.67794004611837
"Nebraska",31067,"Gage County",7445,3385,11119,4060,0.669574602032557,0.304433851965105,0.365140750067452
"Nebraska",31069,"Garden County",1016,161,1200,855,0.846666666666667,0.134166666666667,0.7125
"Nebraska",31071,"Garfield County",933,133,1076,800,0.867100371747212,0.12360594795539,0.743494423791822
"Nebraska",31073,"Gosper County",893,215,1121,678,0.796610169491525,0.191793041926851,0.604817127564674
"Nebraska",31075,"Grant County",375,20,402,355,0.932835820895522,0.0497512437810945,0.883084577114428
"Nebraska",31077,"Greeley County",1016,229,1259,787,0.806989674344718,0.181890389197776,0.625099285146942
"Nebraska",31079,"Hall County",16189,7681,24450,8508,0.662126789366053,0.314151329243354,0.347975460122699
"Nebraska",31081,"Hamilton County",4309,1118,5566,3191,0.774164570607258,0.200862378727991,0.573302191879267
"Nebraska",31083,"Harlan County",1615,282,1934,1333,0.835056876938987,0.145811789038263,0.689245087900724
"Nebraska",31085,"Hayes County",494,34,536,460,0.921641791044776,0.0634328358208955,0.858208955223881
"Nebraska",31087,"Hitchcock County",1264,175,1470,1089,0.859863945578231,0.119047619047619,0.740816326530612
"Nebraska",31089,"Holt County",4769,686,5550,4083,0.859279279279279,0.123603603603604,0.735675675675676
"Nebraska",31091,"Hooker County",376,59,442,317,0.850678733031674,0.133484162895928,0.717194570135747
"Nebraska",31093,"Howard County",2786,648,3511,2138,0.793506123611507,0.184562802620336,0.608943320991171
"Nebraska",31095,"Jefferson County",2616,1016,3730,1600,0.701340482573726,0.272386058981233,0.428954423592493
"Nebraska",31097,"Johnson County",1518,647,2233,871,0.679802955665025,0.2897447380206,0.390058217644424
"Nebraska",31099,"Kearney County",2822,701,3617,2121,0.780204589438761,0.193807022394249,0.586397567044512
"Nebraska",31101,"Keith County",3544,763,4369,2781,0.811169604028382,0.174639505607691,0.636530098420691
"Nebraska",31103,"Keya Paha County",476,49,530,427,0.89811320754717,0.0924528301886792,0.805660377358491
"Nebraska",31105,"Kimball County",1563,268,1877,1295,0.832711774107619,0.142781033564198,0.68993074054342
"Nebraska",31107,"Knox County",3721,905,4708,2816,0.79035683942226,0.192225998300765,0.598130841121495
"Nebraska",31109,"Lancaster County",70092,82293,157215,-12201,0.445835321057151,0.523442419616449,-0.0776070985592978
"Nebraska",31111,"Lincoln County",13071,3692,17163,9379,0.761580143331585,0.215113907824972,0.546466235506613
"Nebraska",31113,"Logan County",407,38,450,369,0.904444444444444,0.0844444444444444,0.82
"Nebraska",31115,"Loup County",370,75,454,295,0.814977973568282,0.165198237885463,0.649779735682819
"Nebraska",31117,"McPherson County",275,17,302,258,0.910596026490066,0.0562913907284768,0.854304635761589
"Nebraska",31119,"Madison County",11940,3478,15819,8462,0.754788545420064,0.219862191036096,0.534926354383969
"Nebraska",31121,"Merrick County",3419,743,4282,2676,0.798458664175619,0.173517048108361,0.624941616067258
"Nebraska",31123,"Morrill County",2113,386,2558,1727,0.826035965598124,0.150899139953088,0.675136825645035
"Nebraska",31125,"Nance County",1437,359,1832,1078,0.78438864628821,0.195960698689956,0.588427947598253
"Nebraska",31127,"Nemaha County",2428,921,3432,1507,0.707459207459207,0.268356643356643,0.439102564102564
"Nebraska",31129,"Nuckolls County",1857,409,2305,1448,0.805639913232104,0.177440347071584,0.628199566160521
"Nebraska",31131,"Otoe County",5649,2490,8355,3159,0.676122082585278,0.29802513464991,0.378096947935368
"Nebraska",31133,"Pawnee County",1071,322,1429,749,0.749475157452764,0.225332400279916,0.524142757172848
"Nebraska",31135,"Perkins County",1321,199,1545,1122,0.855016181229773,0.128802588996764,0.72621359223301
"Nebraska",31137,"Phelps County",4157,752,5021,3405,0.827922724556861,0.149770961959769,0.678151762597092
"Nebraska",31139,"Pierce County",3462,480,4012,2982,0.862911266201396,0.119641076769691,0.743270189431705
"Nebraska",31141,"Platte County",12186,3260,15721,8926,0.775141530436995,0.207365943642262,0.567775586794733
"Nebraska",31143,"Polk County",2291,530,2887,1761,0.793557325943886,0.183581572566678,0.609975753377208
"Nebraska",31145,"Red Willow County",4525,811,5470,3714,0.827239488117002,0.148263254113346,0.678976234003656
"Nebraska",31147,"Richardson County",3073,996,4134,2077,0.743347847121432,0.240928882438316,0.502418964683116
"Nebraska",31149,"Rock County",744,84,842,660,0.883610451306413,0.0997624703087886,0.783847980997625
"Nebraska",31151,"Saline County",3631,1986,5780,1645,0.628200692041523,0.343598615916955,0.284602076124568
"Nebraska",31153,"Sarpy County",51979,41206,96193,10773,0.540361564770825,0.428367968563201,0.111993596207624
"Nebraska",31155,"Saunders County",9108,3331,12786,5777,0.712341623650868,0.260519318004067,0.451822305646801
"Nebraska",31157,"Scotts Bluff County",10952,4196,15524,6756,0.70548827621747,0.270291162071631,0.435197114145839
"Nebraska",31159,"Seward County",6490,2438,9199,4052,0.705511468637895,0.265028807479074,0.440482661158822
"Nebraska",31161,"Sheridan County",2292,340,2684,1952,0.853949329359165,0.126676602086438,0.727272727272727
"Nebraska",31163,"Sherman County",1322,343,1700,979,0.777647058823529,0.201764705882353,0.575882352941176
"Nebraska",31165,"Sioux County",642,72,731,570,0.878248974008208,0.0984952120383037,0.779753761969904
"Nebraska",31167,"Stanton County",2561,532,3165,2029,0.809162717219589,0.168088467614534,0.641074249605055
"Nebraska",31169,"Thayer County",2308,624,2989,1684,0.772164603546337,0.208765473402476,0.563399130143861
"Nebraska",31171,"Thomas County",377,45,427,332,0.882903981264637,0.105386416861827,0.77751756440281
"Nebraska",31173,"Thurston County",1180,1122,2379,58,0.496006725514922,0.471626733921816,0.0243799915931064
"Nebraska",31175,"Valley County",1901,412,2344,1489,0.811006825938567,0.175767918088737,0.635238907849829
"Nebraska",31177,"Washington County",8583,3554,12467,5029,0.688457527873586,0.285072591641935,0.403384936231652
"Nebraska",31179,"Wayne County",3055,1022,4218,2033,0.724276908487435,0.242294926505453,0.481981981981982
"Nebraska",31181,"Webster County",1511,335,1876,1176,0.80543710021322,0.178571428571429,0.626865671641791
"Nebraska",31183,"Wheeler County",438,59,503,379,0.870775347912525,0.117296222664016,0.753479125248509
"Nebraska",31185,"York County",5337,1630,7161,3707,0.745286971093423,0.227621840525066,0.517665130568356
"Nevada",32001,"Churchill County",9372,3051,12890,6321,0.727075252133437,0.236695112490303,0.490380139643134
"Nevada",32003,"Clark County",430930,521852,972510,-90922,0.443111124821339,0.536603222588971,-0.0934920977676323
"Nevada",32005,"Douglas County",21630,11571,34125,10059,0.633846153846154,0.339076923076923,0.294769230769231
"Nevada",32007,"Elko County",16741,4557,21967,12184,0.762097691992534,0.207447534938772,0.554650157053763
"Nevada",32009,"Esmeralda County",400,74,487,326,0.82135523613963,0.151950718685832,0.669404517453799
"Nevada",32011,"Eureka County",895,105,1017,790,0.880039331366765,0.103244837758112,0.776794493608653
"Nevada",32013,"Humboldt County",5877,1689,7771,4188,0.756273323896538,0.217346544846223,0.538926779050315
"Nevada",32015,"Lander County",2198,496,2765,1702,0.79493670886076,0.179385171790235,0.615551537070524
"Nevada",32017,"Lincoln County",2067,330,2446,1737,0.845053147996729,0.134914145543745,0.710139002452984
"Nevada",32019,"Lyon County",20914,8473,30238,12441,0.691646272901647,0.280210331371122,0.411435941530524
"Nevada",32021,"Mineral County",1423,829,2335,594,0.609421841541756,0.355032119914347,0.254389721627409
"Nevada",32023,"Nye County",17528,7288,25378,10240,0.690676964299787,0.28717787059658,0.403499093703207
"Nevada",32027,"Pershing County",1731,547,2320,1184,0.746120689655172,0.235775862068966,0.510344827586207
"Nevada",32029,"Storey County",1908,902,2877,1006,0.663190823774765,0.313521028849496,0.349669794925269
"Nevada",32031,"Washoe County",116760,128128,252142,-11368,0.463072395713526,0.508158101387314,-0.0450857056737871
"Nevada",32033,"White Pine County",3403,859,4369,2544,0.778896772716869,0.196612497138933,0.582284275577935
"Nevada",32510,"Carson City",16113,12735,29739,3378,0.541813779884999,0.428225562392818,0.113588217492182
"New Hampshire",33001,"Belknap County",20899,16894,38453,4005,0.543494655813591,0.439341533820508,0.104153121993082
"New Hampshire",33003,"Carroll County",16150,16649,33272,-499,0.485393123346958,0.500390718922818,-0.0149975955758596
"New Hampshire",33005,"Cheshire County",17892,25506,44206,-7614,0.404741437813871,0.576980500384563,-0.172239062570692
"New Hampshire",33007,"Coos County",8617,7640,16528,977,0.521357696030978,0.462245885769603,0.0591118102613746
"New Hampshire",33009,"Grafton County",19905,33180,53989,-13275,0.368686213858379,0.614569634555187,-0.245883420696809
"New Hampshire",33011,"Hillsborough County",104625,122344,231040,-17719,0.452843663434903,0.529536011080332,-0.0766923476454294
"New Hampshire",33013,"Merrimack County",39711,48533,89887,-8822,0.441788022739662,0.539933472025988,-0.0981454492863262
"New Hampshire",33015,"Rockingham County",95858,100064,198943,-4206,0.48183650593386,0.502978239998392,-0.0211417340645311
"New Hampshire",33017,"Strafford County",30489,41721,73729,-11232,0.413527919814456,0.565869603548129,-0.152341683733673
"New Hampshire",33019,"Sullivan County",11508,12390,24383,-882,0.471968174547841,0.508140917852602,-0.0361727433047614
"New Jersey",34001,"Atlantic County",64438,73808,140441,-9370,0.458826126273666,0.525544534715646,-0.0667184084419791
"New Jersey",34003,"Bergen County",204417,285967,497460,-81550,0.41092148112411,0.574854259638966,-0.163932778514855
"New Jersey",34005,"Burlington County",103345,154595,262650,-51250,0.393470397867885,0.588596992194936,-0.195126594327051
"New Jersey",34007,"Camden County",86207,175065,265599,-88858,0.324575770240099,0.659132752758858,-0.33455698251876
"New Jersey",34009,"Cape May County",33158,23941,57933,9217,0.572350819049592,0.413253240812663,0.159097578236929
"New Jersey",34011,"Cumberland County",28952,32742,62575,-3790,0.462676787854575,0.523244107071514,-0.0605673192169396
"New Jersey",34013,"Essex County",75475,266820,345311,-191345,0.218571085195664,0.772694759217054,-0.55412367402139
"New Jersey",34015,"Gloucester County",83340,86702,173453,-3362,0.480475979083671,0.49985875136204,-0.0193827722783694
"New Jersey",34017,"Hudson County",65698,181452,250458,-115754,0.262311445431969,0.724480751263685,-0.462169305831716
"New Jersey",34019,"Hunterdon County",43153,39457,84673,3696,0.509642979462166,0.465992701333365,0.0436502781288014
"New Jersey",34021,"Mercer County",51641,122532,177223,-70891,0.291389943743194,0.691400100438431,-0.400010156695237
"New Jersey",34023,"Middlesex County",143467,226250,375692,-82783,0.381873981878773,0.602222032941878,-0.220348051063105
"New Jersey",34025,"Monmouth County",191808,181291,378390,10517,0.506905573614525,0.479111498718254,0.0277940748962711
"New Jersey",34027,"Morris County",141134,153881,300917,-12747,0.469013050110163,0.511373568126759,-0.0423605180165959
"New Jersey",34029,"Ocean County",217740,119456,342746,98284,0.635280936903713,0.348526313946771,0.286754622956942
"New Jersey",34031,"Passaic County",92009,129097,224330,-37088,0.410150225114786,0.575478090313378,-0.165327865198591
"New Jersey",34033,"Salem County",18827,14479,34042,4348,0.553052112096822,0.425327536572469,0.127724575524352
"New Jersey",34035,"Somerset County",71996,111173,186891,-39177,0.385229893360301,0.594854754910616,-0.209624861550315
"New Jersey",34037,"Sussex County",51698,34481,88352,17217,0.585136725823977,0.390268471568272,0.194868254255704
"New Jersey",34039,"Union County",80002,170245,254041,-90243,0.314917670769679,0.670147732058998,-0.355230061289319
"New Jersey",34041,"Warren County",34769,24901,61057,9868,0.569451496142948,0.407832025811946,0.161619470331002
"New Mexico",35001,"Bernalillo County",116135,193757,317590,-77622,0.36567587140653,0.610085330142637,-0.244409458736106
"New Mexico",35003,"Catron County",1698,595,2326,1103,0.730008598452279,0.255803955288048,0.47420464316423
"New Mexico",35005,"Chaves County",15656,6381,22443,9275,0.697589448825915,0.284320278037695,0.413269170788219
"New Mexico",35006,"Cibola County",3975,4745,8903,-770,0.446478715039874,0.532966415814894,-0.0864877007750197
"New Mexico",35007,"Colfax County",3271,2611,6016,660,0.543716755319149,0.434009308510638,0.109707446808511
"New Mexico",35009,"Curry County",10444,4307,15101,6137,0.691609827163764,0.28521289980796,0.406396927355804
"New Mexico",35011,"De Baca County",656,231,901,425,0.728079911209767,0.25638179800222,0.471698113207547
"New Mexico",35013,"Doña Ana County",32802,47957,82641,-15155,0.396921624859331,0.5803051753972,-0.183383550537869
"New Mexico",35015,"Eddy County",17454,5424,23222,12030,0.751614847988976,0.233571613125484,0.518043234863491
"New Mexico",35017,"Grant County",6553,7590,14435,-1037,0.453966054728091,0.525805334257014,-0.0718392795289228
"New Mexico",35019,"Guadalupe County",917,1234,2189,-317,0.418912745545911,0.563727729556875,-0.144814984010964
"New Mexico",35021,"Harding County",319,179,505,140,0.631683168316832,0.354455445544554,0.277227722772277
"New Mexico",35023,"Hidalgo County",1120,823,1974,297,0.567375886524823,0.416919959473151,0.150455927051672
"New Mexico",35025,"Lea County",16531,4061,20918,12470,0.790276317047519,0.194139019026676,0.596137298020843
"New Mexico",35027,"Lincoln County",6942,3194,10306,3748,0.673588201047933,0.309916553464002,0.363671647583932
"New Mexico",35028,"Los Alamos County",4278,7554,12293,-3276,0.348002928495892,0.614496054665257,-0.266493126169365
"New Mexico",35029,"Luna County",4408,3563,8103,845,0.543996050845366,0.439713686289029,0.104282364556337
"New Mexico",35031,"McKinley County",7801,18029,26486,-10228,0.294532960809484,0.680699237332931,-0.386166276523446
"New Mexico",35033,"Mora County",903,1745,2686,-842,0.336187639612807,0.649664929262844,-0.313477289650037
"New Mexico",35035,"Otero County",14521,8485,23571,6036,0.616053625217428,0.359976241992279,0.25607738322515
"New Mexico",35037,"Quay County",2634,1170,3873,1464,0.68009295120062,0.302091402013943,0.378001549186677
"New Mexico",35039,"Rio Arriba County",5408,10990,16628,-5582,0.32523454414241,0.660933365407746,-0.335698821265336
"New Mexico",35041,"Roosevelt County",4634,1802,6608,2832,0.701271186440678,0.272699757869249,0.428571428571429
"New Mexico",35043,"Sandoval County",34174,40588,76562,-6414,0.446357200700086,0.530132441681252,-0.0837752409811656
"New Mexico",35045,"San Juan County",32874,18083,52294,14791,0.628638084675106,0.345794928672505,0.282843156002601
"New Mexico",35047,"San Miguel County",3421,7888,11531,-4467,0.296678518775475,0.684069031306912,-0.387390512531437
"New Mexico",35049,"Santa Fe County",18329,62530,82227,-44201,0.222907317547764,0.760455811351503,-0.537548493803738
"New Mexico",35051,"Sierra County",3542,2265,5945,1277,0.595794785534062,0.380992430613961,0.214802354920101
"New Mexico",35053,"Socorro County",3255,3722,7160,-467,0.454608938547486,0.519832402234637,-0.0652234636871509
"New Mexico",35055,"Taos County",3715,13121,17181,-9406,0.216227227751586,0.763692450963273,-0.547465223211687
"New Mexico",35057,"Torrance County",4772,2344,7281,2428,0.65540447740695,0.321933800302156,0.333470677104793
"New Mexico",35059,"Union County",1388,383,1789,1005,0.775852431525992,0.214086081609838,0.561766349916154
"New Mexico",35061,"Valencia County",17364,14263,32277,3101,0.537968212659169,0.441893608451839,0.0960746042073303
"New York",36001,"Albany County",51081,99474,154101,-48393,0.331477407674188,0.645511709852629,-0.314034302178441
"New York",36003,"Allegany County",14135,6048,20782,8087,0.68015590414782,0.291021075931094,0.389134828216726
"New York",36005,"Bronx County",67740,355374,425715,-287634,0.159120538388358,0.834769740319228,-0.675649201930869
"New York",36007,"Broome County",43800,47010,92794,-3210,0.472013276720478,0.506606030562321,-0.0345927538418432
"New York",36009,"Cattaraugus County",22155,11879,34845,10276,0.635815755488592,0.340909743148228,0.294906012340365
"New York",36011,"Cayuga County",19512,16149,36421,3363,0.535734878229593,0.443398039592543,0.0923368386370501
"New York",36013,"Chautauqua County",34853,23087,59304,11766,0.587700661000944,0.389299204100904,0.19840145690004
"New York",36015,"Chemung County",21922,16636,39410,5286,0.556254757675717,0.422126363867039,0.134128393808678
"New York",36017,"Chenango County",13482,8290,22282,5192,0.605062382191904,0.372049187685127,0.233013194506777
"New York",36019,"Clinton County",16514,18364,35437,-1850,0.466010102435308,0.518215424556255,-0.0522053221209471
"New York",36021,"Columbia County",14464,20386,35522,-5922,0.407184280164405,0.573897866111142,-0.166713585946737
"New York",36023,"Cortland County",10789,10369,21678,420,0.497693514161823,0.478319033121137,0.0193744810406864
"New York",36025,"Delaware County",13387,9143,23025,4244,0.581411509229099,0.397090119435396,0.184321389793702
"New York",36027,"Dutchess County",66872,81443,151122,-14571,0.44250340784267,0.538922195312397,-0.0964187874697264
"New York",36029,"Erie County",197527,267174,473021,-69647,0.41758611139886,0.564824817502817,-0.147238706103957
"New York",36031,"Essex County",8976,9947,19259,-971,0.466067812451322,0.516485798847292,-0.0504179863959707
"New York",36033,"Franklin County",9668,9253,19268,415,0.501764583765829,0.480226281918206,0.021538301847623
"New York",36035,"Fulton County",15378,7931,23744,7447,0.647658355795148,0.334021226415094,0.313637129380054
"New York",36037,"Genesee County",18876,9625,29217,9251,0.646062224047643,0.329431495362289,0.316630728685354
"New York",36039,"Greene County",14271,10346,25194,3925,0.566444391521791,0.410653330157974,0.155791061363817
"New York",36041,"Hamilton County",2225,1178,3460,1047,0.643063583815029,0.340462427745665,0.302601156069364
"New York",36043,"Herkimer County",18870,9937,29319,8933,0.643609945768955,0.338926975681299,0.304682970087656
"New York",36045,"Jefferson County",25629,17307,43848,8322,0.584496442255063,0.394704433497537,0.189792008757526
"New York",36047,"Kings County",202772,703310,913246,-500538,0.222034369709804,0.77012108457086,-0.548086714861056
"New York",36049,"Lewis County",8894,3824,12944,5070,0.687113720642769,0.295426452410383,0.391687268232386
"New York",36051,"Livingston County",18182,12477,31401,5705,0.579026145664151,0.397344033629502,0.181682112034649
"New York",36053,"Madison County",18408,14807,34038,3601,0.540807332980786,0.435013808096833,0.105793524883953
"New York",36055,"Monroe County",145661,225746,380983,-80085,0.382329395274855,0.592535624949145,-0.21020622967429
"New York",36057,"Montgomery County",12745,7977,21134,4768,0.603056685908962,0.377448660925523,0.225608024983439
"New York",36059,"Nassau County",326716,396504,732756,-69788,0.445872841709928,0.541113276452189,-0.0952404347422607
"New York",36061,"New York County",85185,603040,694904,-517855,0.122585277966453,0.86780332247332,-0.745218044506867
"New York",36063,"Niagara County",56068,46029,104080,10039,0.53870099923136,0.442246348962337,0.0964546502690238
"New York",36065,"Oneida County",57180,41567,100746,15613,0.567565957953666,0.412592063208465,0.154973894745201
"New York",36067,"Onondaga County",90619,138894,234735,-48275,0.386048096789997,0.591705540290114,-0.205657443500117
"New York",36069,"Ontario County",29039,29025,59674,14,0.486627341890941,0.48639273385394,0.000234608037001038
"New York",36071,"Orange County",84996,84684,172099,312,0.493878523408038,0.49206561339694,0.00181291001109823
"New York",36073,"Orleans County",12126,5587,18154,6539,0.667951966508758,0.307755866475708,0.360196100033051
"New York",36075,"Oswego County",32138,21143,54491,10995,0.589785469160045,0.388009029013966,0.201776440146079
"New York",36077,"Otsego County",14382,12975,28008,1407,0.513496143958869,0.463260497000857,0.050235646958012
"New York",36079,"Putnam County",29283,24953,54989,4330,0.532524686755533,0.453781665423994,0.078743021331539
"New York",36081,"Queens County",212665,569038,787860,-356373,0.269927398268728,0.722257761531237,-0.452330363262509
"New York",36083,"Rensselaer County",36500,40969,79409,-4469,0.459645632107192,0.515923887720535,-0.0562782556133435
"New York",36085,"Richmond County",123320,90997,216153,32323,0.570521806313121,0.420984210258474,0.149537596054646
"New York",36087,"Rockland County",73186,75802,150369,-2616,0.48670936163704,0.504106564517953,-0.017397202880913
"New York",36089,"St. Lawrence County",24608,19361,44907,5247,0.547976930099984,0.43113545772374,0.116841472376244
"New York",36091,"Saratoga County",61305,68471,132655,-7166,0.462138630281557,0.516158456145641,-0.0540198258640835
"New York",36093,"Schenectady County",30741,42465,74826,-11724,0.410833132868254,0.567516638601556,-0.156683505733301
"New York",36095,"Schoharie County",9903,5345,15710,4558,0.630362826225334,0.340229153405474,0.29013367281986
"New York",36097,"Schuyler County",5621,3903,9766,1718,0.57556829817735,0.399651853368831,0.175916444808519
"New York",36099,"Seneca County",8329,6914,15630,1415,0.532885476647473,0.442354446577095,0.0905310300703774
"New York",36101,"Steuben County",29474,15790,46178,13684,0.638269305730001,0.341937719260254,0.296331586469747
"New York",36103,"Suffolk County",381253,381021,771541,232,0.494144834817592,0.493844137900643,0.000300696916949283
"New York",36105,"Sullivan County",18665,15489,34647,3176,0.538719081017116,0.447051692787254,0.0916673882298612
"New York",36107,"Tioga County",14791,9634,25044,5157,0.590600543044242,0.384682957993931,0.205917585050311
"New York",36109,"Tompkins County",11096,33619,45735,-22523,0.24261506504865,0.735082540723735,-0.492467475675085
"New York",36111,"Ulster County",37590,57970,97420,-20380,0.385855060562513,0.595052350646684,-0.209197290084172
"New York",36113,"Warren County",17699,17642,36131,57,0.489856356037752,0.48827876338878,0.00157759264897178
"New York",36115,"Washington County",15941,11565,28138,4376,0.566529248702822,0.41101002203426,0.155519226668562
"New York",36117,"Wayne County",26204,17456,44714,8748,0.586035693518808,0.39039227087713,0.195643422641678
"New York",36119,"Westchester County",144713,312371,462122,-167658,0.313148908729729,0.675949208217743,-0.362800299488014
"New York",36121,"Wyoming County",13898,5073,19399,8825,0.716428681890819,0.261508325171401,0.454920356719418
"New York",36123,"Yates County",6208,4219,10701,1989,0.580132697878703,0.394262218484254,0.185870479394449
"North Carolina",37001,"Alamance County",46056,38825,86091,7231,0.534968812070948,0.450976292527674,0.083992519543274
"North Carolina",37003,"Alexander County",15888,4145,20236,11743,0.78513540225341,0.204832970942874,0.580302431310536
"North Carolina",37005,"Alleghany County",4527,1486,6076,3041,0.74506254114549,0.24456879526004,0.500493745885451
"North Carolina",37007,"Anson County",5321,5789,11194,-468,0.475343934250491,0.517152045738789,-0.0418081114882973
"North Carolina",37009,"Ashe County",11451,4164,15814,7287,0.724105223219932,0.263310990261793,0.460794232958138
"North Carolina",37011,"Avery County",7172,2191,9458,4981,0.758299851977162,0.231655741171495,0.526644110805667
"North Carolina",37013,"Beaufort County",16437,9633,26315,6804,0.624624738742162,0.366064981949458,0.258559756792704
"North Carolina",37015,"Bertie County",3817,5939,9815,-2122,0.38889454915945,0.60509424350484,-0.21619969434539
"North Carolina",37017,"Bladen County",9676,7326,17125,2350,0.565021897810219,0.427795620437956,0.137226277372263
"North Carolina",37019,"Brunswick County",55850,33310,90175,22540,0.619351261436097,0.369392847241475,0.249958414194622
"North Carolina",37021,"Buncombe County",62412,96515,161569,-34103,0.386286973367416,0.597360879871758,-0.211073906504342
"North Carolina",37023,"Burke County",31019,13118,44602,17901,0.695462086901933,0.294112371642527,0.401349715259405
"North Carolina",37025,"Cabarrus County",63237,52162,117227,11075,0.539440572564341,0.444965750211129,0.0944748223532121
"North Carolina",37027,"Caldwell County",32119,10245,42829,21874,0.749935791169535,0.239207079315417,0.510728711854118
"North Carolina",37029,"Camden County",4312,1537,5953,2775,0.724340668570469,0.258189148328574,0.466151520241895
"North Carolina",37031,"Carteret County",30028,12093,42695,17935,0.70331420541047,0.283241597376742,0.420072608033728
"North Carolina",37033,"Caswell County",7089,4860,12051,2229,0.588249937764501,0.403286034353996,0.184963903410505
"North Carolina",37035,"Catawba County",56588,25689,83425,30899,0.67830985915493,0.307929277794426,0.370380581360503
"North Carolina",37037,"Chatham County",21186,26787,48599,-5601,0.435934895779748,0.55118418074446,-0.115249284964711
"North Carolina",37039,"Cherokee County",12628,3583,16423,9045,0.768921634293369,0.21816964013883,0.550751994154539
"North Carolina",37041,"Chowan County",4471,3247,7784,1224,0.574383350462487,0.417137718396711,0.157245632065776
"North Carolina",37043,"Clay County",5112,1699,6893,3413,0.741621935296678,0.246481938198172,0.495139997098506
"North Carolina",37045,"Cleveland County",33798,16955,51308,16843,0.658727683792001,0.33045528962345,0.328272394168551
"North Carolina",37047,"Columbus County",16832,9446,26446,7386,0.636466762459351,0.357180670044619,0.279286092414732
"North Carolina",37049,"Craven County",31032,21148,53065,9884,0.584792235937058,0.398530104588712,0.186262131348346
"North Carolina",37051,"Cumberland County",60032,84469,147150,-24437,0.407964661909616,0.5740332993544,-0.166068637444784
"North Carolina",37053,"Currituck County",11657,4195,16147,7462,0.721929770235957,0.259800582151483,0.462129188084474
"North Carolina",37055,"Dare County",13938,9936,24232,4002,0.5751898316276,0.410036315615715,0.165153516011885
"North Carolina",37057,"Davidson County",64658,22636,88514,42022,0.730483313374156,0.255733556273584,0.474749757100572
"North Carolina",37059,"Davie County",18228,6713,25311,11515,0.720161194737466,0.265220655051164,0.454940539686302
"North Carolina",37061,"Duplin County",13793,8767,22715,5026,0.607219898745322,0.385956416464891,0.221263482280431
"North Carolina",37063,"Durham County",32459,144688,179914,-112229,0.180413975566104,0.804206454194782,-0.623792478628678
"North Carolina",37065,"Edgecombe County",9206,16089,25477,-6883,0.361345527338384,0.63151077442399,-0.270165247085607
"North Carolina",37067,"Forsyth County",85064,113033,201270,-27969,0.422636259750584,0.561598847319521,-0.138962587568937
"North Carolina",37069,"Franklin County",20901,15879,37351,5022,0.559583411421381,0.425129179941635,0.134454231479746
"North Carolina",37071,"Gaston County",73033,40959,115498,32074,0.632331295780013,0.354629517394241,0.277701778385773
"North Carolina",37073,"Gates County",3367,2546,5971,821,0.563892145369285,0.426394238820968,0.137497906548317
"North Carolina",37075,"Graham County",3710,905,4665,2805,0.795284030010718,0.193997856377278,0.60128617363344
"North Carolina",37077,"Granville County",16647,14565,31598,2082,0.52683714159124,0.460946895373125,0.0658902462181151
"North Carolina",37079,"Greene County",4874,3832,8753,1042,0.556837655660916,0.437792756769108,0.119044898891809
"North Carolina",37081,"Guilford County",107294,173086,284486,-65792,0.377150369438215,0.608416582889843,-0.231266213451629
"North Carolina",37083,"Halifax County",10080,15545,25759,-5465,0.391319538801972,0.603478395900462,-0.21215885709849
"North Carolina",37085,"Harnett County",35177,22093,58293,13084,0.603451529343146,0.378999193728235,0.224452335614911
"North Carolina",37087,"Haywood County",22834,13144,36542,9690,0.624870012588255,0.359695692627661,0.265174319960593
"North Carolina",37089,"Henderson County",40032,27211,68371,12821,0.585511401032602,0.397990376036624,0.187521024995978
"North Carolina",37091,"Hertford County",3479,7097,10634,-3618,0.327158171901448,0.667387624600339,-0.34022945269889
"North Carolina",37093,"Hoke County",9453,11804,21639,-2351,0.436850131706641,0.545496557142197,-0.108646425435556
"North Carolina",37095,"Hyde County",1418,1046,2492,372,0.569020866773676,0.419743178170145,0.149277688603531
"North Carolina",37097,"Iredell County",67010,33888,102371,33122,0.654579910326167,0.331031249084213,0.323548661241953
"North Carolina",37099,"Jackson County",11356,9591,21428,1765,0.529960798954639,0.447591935784954,0.0823688631696845
"North Carolina",37101,"Johnston County",68353,41257,111357,27096,0.613818619395278,0.370493098772417,0.243325520622862
"North Carolina",37103,"Jones County",3280,2197,5525,1083,0.593665158371041,0.397647058823529,0.196018099547511
"North Carolina",37105,"Lee County",16469,12143,29008,4326,0.567739933811362,0.418608659680088,0.149131274131274
"North Carolina",37107,"Lenoir County",14590,13605,28409,985,0.513569643422859,0.478897532472104,0.034672110950755
"North Carolina",37109,"Lincoln County",36341,13274,50217,23067,0.723679232132545,0.264332795666806,0.459346436465739
"North Carolina",37111,"McDowell County",16883,5832,23003,11051,0.733947745946181,0.253532147980698,0.480415597965483
"North Carolina",37113,"Macon County",14211,6230,20743,7981,0.685098587475293,0.300342284144049,0.384756303331244
"North Carolina",37115,"Madison County",7979,4901,13076,3078,0.610201896604466,0.374808810033649,0.235393086570817
"North Carolina",37117,"Martin County",6532,5911,12540,621,0.520893141945774,0.471371610845295,0.0495215311004785
"North Carolina",37119,"Mecklenburg County",179211,378107,567053,-198896,0.316039241481837,0.666793051090462,-0.350753809608626
"North Carolina",37121,"Mitchell County",7090,1867,9041,5223,0.784205287025772,0.206503705342329,0.577701581683442
"North Carolina",37123,"Montgomery County",8411,4327,12849,4084,0.654603471087244,0.336757724336524,0.31784574675072
"North Carolina",37125,"Moore County",36764,20779,58339,15985,0.630178782632544,0.356176828536656,0.274001954095888
"North Carolina",37127,"Nash County",25827,25947,52271,-120,0.494098065849132,0.496393793881885,-0.00229572803275241
"North Carolina",37129,"New Hanover County",63331,66138,131830,-2807,0.48039899871046,0.501691572479709,-0.0212925737692483
"North Carolina",37131,"Northampton County",3989,6069,10109,-2080,0.394598872292017,0.600356118310416,-0.205757246018399
"North Carolina",37133,"Onslow County",46078,24266,72235,21812,0.637890219422718,0.335931335225306,0.301958884197411
"North Carolina",37135,"Orange County",20176,63594,84997,-43418,0.237373083755897,0.748191112627504,-0.510818028871607
"North Carolina",37137,"Pamlico County",4849,2713,7631,2136,0.635434412265758,0.355523522474119,0.279910889791639
"North Carolina",37139,"Pasquotank County",9770,9832,19897,-62,0.491028798311303,0.494144845956677,-0.00311604764537371
"North Carolina",37141,"Pender County",21956,11723,34169,10233,0.642570751265767,0.34308876466973,0.299481986596037
"North Carolina",37143,"Perquimans County",4903,2492,7484,2411,0.655130946018172,0.332977017637627,0.322153928380545
"North Carolina",37145,"Person County",13184,8465,21894,4719,0.602174111628757,0.386635607929113,0.215538503699644
"North Carolina",37147,"Pitt County",38982,47252,87573,-8270,0.445137199821863,0.539572699347973,-0.0944354995261097
"North Carolina",37149,"Polk County",7689,4518,12358,3171,0.622188056319793,0.365593138048228,0.256594918271565
"North Carolina",37151,"Randolph County",56894,15618,73316,41276,0.77601069343663,0.213023078182116,0.562987615254515
"North Carolina",37153,"Richmond County",11830,8754,20763,3076,0.569763521649087,0.421615373500939,0.148148148148148
"North Carolina",37155,"Robeson County",27806,19020,47188,8786,0.589259981351191,0.403068576756803,0.186191404594388
"North Carolina",37157,"Rockingham County",31301,15992,47809,15309,0.654709364345625,0.334497688719697,0.320211675625928
"North Carolina",37159,"Rowan County",49297,23114,73408,26183,0.671548060156931,0.314870313862249,0.356677746294682
"North Carolina",37161,"Rutherford County",24891,9135,34429,15756,0.72296610415638,0.265328647361236,0.457637456795144
"North Carolina",37163,"Sampson County",17411,10966,28618,6445,0.608393318890209,0.38318540778531,0.225207911104899
"North Carolina",37165,"Scotland County",7473,7186,14775,287,0.505786802030457,0.486362098138748,0.019424703891709
"North Carolina",37167,"Stanly County",25458,8129,33939,17329,0.750110492353929,0.239517958690592,0.510592533663337
"North Carolina",37169,"Stokes County",20142,5286,25701,14856,0.783704914205673,0.205672931014357,0.578031983191315
"North Carolina",37171,"Surry County",27538,8721,36638,18817,0.751623996943065,0.238031551940608,0.513592445002456
"North Carolina",37173,"Swain County",4161,2780,7068,1381,0.588709677419355,0.393322014714205,0.19538766270515
"North Carolina",37175,"Transylvania County",11636,8444,20404,3192,0.570280337188786,0.413840423446383,0.156439913742403
"North Carolina",37177,"Tyrrell County",1044,758,1817,286,0.574573472757292,0.417171161254816,0.157402311502477
"North Carolina",37179,"Union County",80382,48725,131011,31657,0.61355153384067,0.37191533535352,0.24163619848715
"North Carolina",37181,"Vance County",8391,12431,20999,-4040,0.399590456688414,0.591980570503357,-0.192390113814944
"North Carolina",37183,"Wake County",226197,393336,631830,-167139,0.358002943829828,0.622534542519349,-0.264531598689521
"North Carolina",37185,"Warren County",3752,6400,10293,-2648,0.364519576411153,0.62178179345186,-0.257262217040707
"North Carolina",37187,"Washington County",2781,3396,6205,-615,0.448186946011281,0.547300564061241,-0.0991136180499597
"North Carolina",37189,"Watauga County",14451,17122,32220,-2671,0.448510242085661,0.531409062693979,-0.0828988206083178
"North Carolina",37191,"Wayne County",30709,24215,55537,6494,0.55294668419252,0.43601562922016,0.116931054972361
"North Carolina",37193,"Wilkes County",27592,7511,35466,20081,0.77798454858174,0.211780296622117,0.566204251959623
"North Carolina",37195,"Wilson County",19581,20754,40735,-1173,0.480692279366638,0.509488155149135,-0.0287958757824966
"North Carolina",37197,"Yadkin County",15933,3763,19923,12170,0.799728956482457,0.188877177131958,0.610851779350499
"North Carolina",37199,"Yancey County",7516,3688,11352,3828,0.662085976039464,0.324876673713883,0.337209302325581
"North Dakota",38001,"Adams County",981,258,1269,723,0.773049645390071,0.203309692671395,0.569739952718676
"North Dakota",38003,"Barnes County",3568,1820,5565,1748,0.64115004492363,0.327044025157233,0.314106019766397
"North Dakota",38005,"Benson County",1094,822,1961,272,0.557878633350331,0.419173890872004,0.138704742478327
"North Dakota",38007,"Billings County",541,72,635,469,0.851968503937008,0.113385826771654,0.738582677165354
"North Dakota",38009,"Bottineau County",2575,821,3471,1754,0.741861135119562,0.236531259003169,0.505329876116393
"North Dakota",38011,"Bowman County",1395,228,1657,1167,0.84188292094146,0.137598068799034,0.704284852142426
"North Dakota",38013,"Burke County",994,137,1155,857,0.860606060606061,0.118614718614719,0.741991341991342
"North Dakota",38015,"Burleigh County",34744,14348,50753,20396,0.68457037022442,0.282702500344807,0.401867869879613
"North Dakota",38017,"Cass County",42619,40311,86053,2308,0.495264546267998,0.468443865989565,0.0268206802784331
"North Dakota",38019,"Cavalier County",1499,474,2020,1025,0.742079207920792,0.234653465346535,0.507425742574257
"North Dakota",38021,"Dickey County",1742,608,2424,1134,0.718646864686469,0.250825082508251,0.467821782178218
"North Dakota",38023,"Divide County",904,265,1202,639,0.752079866888519,0.220465890183028,0.531613976705491
"North Dakota",38025,"Dunn County",1951,342,2338,1609,0.834473909324209,0.146278870829769,0.68819503849444
"North Dakota",38027,"Eddy County",854,383,1261,471,0.677240285487708,0.303727200634417,0.373513084853291
"North Dakota",38029,"Emmons County",1738,237,2009,1501,0.865107018417123,0.117969138875062,0.747137879542061
"North Dakota",38031,"Foster County",1362,373,1778,989,0.766029246344207,0.209786276715411,0.556242969628796
"North Dakota",38033,"Golden Valley County",871,137,1026,734,0.848927875243665,0.133528265107212,0.715399610136452
"North Dakota",38035,"Grand Forks County",16987,12880,30970,4107,0.548498546980949,0.415886341620923,0.132612205360026
"North Dakota",38037,"Grant County",1145,207,1381,938,0.829109341057205,0.149891383055757,0.679217958001448
"North Dakota",38039,"Griggs County",907,308,1250,599,0.7256,0.2464,0.4792
"North Dakota",38041,"Hettinger County",1091,196,1312,895,0.83155487804878,0.149390243902439,0.682164634146341
"North Dakota",38043,"Kidder County",1215,221,1460,994,0.832191780821918,0.151369863013699,0.680821917808219
"North Dakota",38045,"LaMoure County",1645,527,2219,1118,0.741324921135647,0.237494366831906,0.50383055430374
"North Dakota",38047,"Logan County",930,128,1076,802,0.864312267657993,0.118959107806691,0.745353159851301
"North Dakota",38049,"McHenry County",2364,564,3003,1800,0.787212787212787,0.187812187812188,0.599400599400599
"North Dakota",38051,"McIntosh County",1153,261,1455,892,0.792439862542955,0.179381443298969,0.613058419243986
"North Dakota",38053,"McKenzie County",4482,814,5419,3668,0.827089868979517,0.150212216276066,0.676877652703451
"North Dakota",38055,"McLean County",4198,1230,5536,2968,0.758309248554913,0.222182080924856,0.536127167630058
"North Dakota",38057,"Mercer County",3856,704,4675,3152,0.824812834224599,0.150588235294118,0.674224598930481
"North Dakota",38059,"Morton County",12243,3872,16619,8371,0.736686924604368,0.232986340935074,0.503700583669294
"North Dakota",38061,"Mountrail County",2824,1256,4165,1568,0.678031212484994,0.3015606242497,0.376470588235294
"North Dakota",38063,"Nelson County",1141,586,1777,555,0.642093415869443,0.3297692740574,0.312324141812043
"North Dakota",38065,"Oliver County",918,129,1066,789,0.861163227016886,0.121013133208255,0.74015009380863
"North Dakota",38067,"Pembina County",2460,786,3331,1674,0.738516961873311,0.235965175622936,0.502551786250375
"North Dakota",38069,"Pierce County",1585,497,2128,1088,0.744830827067669,0.233552631578947,0.511278195488722
"North Dakota",38071,"Ramsey County",3577,1639,5372,1938,0.665860014892033,0.305100521221147,0.360759493670886
"North Dakota",38073,"Ransom County",1418,945,2454,473,0.577832110839446,0.385085574572127,0.192746536267319
"North Dakota",38075,"Renville County",1065,220,1319,845,0.807429871114481,0.166793025018954,0.640636846095527
"North Dakota",38077,"Richland County",5072,2510,7812,2562,0.649257552483359,0.321300563236047,0.327956989247312
"North Dakota",38079,"Rolette County",1257,2482,3804,-1225,0.330441640378549,0.652471083070452,-0.322029442691903
"North Dakota",38081,"Sargent County",1266,738,2070,528,0.611594202898551,0.356521739130435,0.255072463768116
"North Dakota",38083,"Sheridan County",688,104,812,584,0.847290640394089,0.12807881773399,0.719211822660099
"North Dakota",38085,"Sioux County",258,804,1186,-546,0.217537942664418,0.677908937605396,-0.460370994940978
"North Dakota",38087,"Slope County",380,44,427,336,0.889929742388759,0.103044496487119,0.786885245901639
"North Dakota",38089,"Stark County",12110,2499,15050,9611,0.804651162790698,0.166046511627907,0.638604651162791
"North Dakota",38091,"Steele County",652,392,1088,260,0.599264705882353,0.360294117647059,0.238970588235294
"North Dakota",38093,"Stutsman County",6994,2676,9959,4318,0.702279345315795,0.268701676875188,0.433577668440606
"North Dakota",38095,"Towner County",830,317,1174,513,0.706984667802385,0.270017035775128,0.436967632027257
"North Dakota",38097,"Traill County",2522,1493,4136,1029,0.609767891682785,0.360976789168279,0.248791102514507
"North Dakota",38099,"Walsh County",3324,1333,4783,1991,0.694961321346435,0.278695379468953,0.416265941877483
"North Dakota",38101,"Ward County",19974,7293,28246,12681,0.707144374424697,0.258195850739928,0.44894852368477
"North Dakota",38103,"Wells County",1893,442,2374,1451,0.797388374052233,0.186183656276327,0.611204717775906
"North Dakota",38105,"Williams County",11739,2169,14334,9570,0.81896190874843,0.151318543323566,0.667643365424864
"Ohio",39001,"Adams County",9870,2156,12145,7714,0.812680115273775,0.177521613832853,0.635158501440922
"Ohio",39003,"Allen County",33116,14149,48006,18967,0.689830437861934,0.294733991584385,0.395096446277549
"Ohio",39005,"Ashland County",19407,6541,26405,12866,0.734974436659724,0.24771823518273,0.487256201476993
"Ohio",39007,"Ashtabula County",26890,16497,44147,10393,0.609101411194419,0.373683375993839,0.23541803520058
"Ohio",39009,"Athens County",10862,14772,26059,-3910,0.416823362370007,0.566867492996661,-0.150044130626655
"Ohio",39011,"Auglaize County",20798,4651,25777,16147,0.806843309927455,0.180432168211972,0.626411141715483
"Ohio",39013,"Belmont County",23560,9138,33088,14422,0.712040618955513,0.276172630560928,0.435867988394584
"Ohio",39015,"Brown County",16480,4380,21096,12100,0.781190747061054,0.207622298065984,0.57356844899507
"Ohio",39017,"Butler County",114392,69613,186737,44779,0.612583473012847,0.372786325152487,0.23979714786036
"Ohio",39019,"Carroll County",10745,3251,14212,7494,0.756051224317478,0.228750351815367,0.527300872502111
"Ohio",39021,"Champaign County",14589,5062,19972,9527,0.730472661726417,0.25345483677148,0.477017824954937
"Ohio",39023,"Clark County",39032,24076,64212,14956,0.607861458917336,0.374945493054258,0.232915965863079
"Ohio",39025,"Clermont County",74570,34092,110480,40478,0.674963794351919,0.308580738595221,0.366383055756698
"Ohio",39027,"Clinton County",15488,4697,20527,10791,0.754518439128952,0.228820577775613,0.52569786135334
"Ohio",39029,"Columbiana County",35726,13359,49860,22367,0.716526273565985,0.267930204572804,0.448596068993181
"Ohio",39031,"Coshocton County",12325,4125,16739,8200,0.736304438735886,0.246430491666169,0.489873947069717
"Ohio",39033,"Crawford County",15436,4916,20686,10520,0.746205162912114,0.237648651261723,0.508556511650392
"Ohio",39035,"Cuyahoga County",202699,416176,625670,-213477,0.323971102977608,0.665168539325843,-0.341197436348235
"Ohio",39037,"Darke County",22004,4731,27134,17273,0.810938306184123,0.174356895407975,0.636581410776148
"Ohio",39039,"Defiance County",13038,5981,19381,7057,0.672720705845932,0.308601207368041,0.364119498477891
"Ohio",39041,"Delaware County",66356,57735,126070,8621,0.526342508130404,0.457959863567859,0.0683826445625446
"Ohio",39043,"Erie County",22160,17493,40335,4667,0.549398785174166,0.433692822610636,0.11570596256353
"Ohio",39045,"Fairfield County",50797,31224,83311,19573,0.609727406945061,0.374788443302805,0.234938963642256
"Ohio",39047,"Fayette County",9473,2975,12612,6498,0.751110053916905,0.235886457342214,0.515223596574691
"Ohio",39049,"Franklin County",211237,409144,630577,-197907,0.334990017079595,0.648840664978266,-0.313850647898671
"Ohio",39051,"Fulton County",15731,6664,22770,9067,0.690865173473869,0.292665788317962,0.398199385155907
"Ohio",39053,"Gallia County",10645,2990,13799,7655,0.7714327125154,0.216682368287557,0.554750344227843
"Ohio",39055,"Geauga County",34143,21201,56021,12942,0.609467878117135,0.378447367951304,0.231020510165831
"Ohio",39057,"Greene County",52072,34798,88643,17274,0.587434992046749,0.392563428584321,0.194871563462428
"Ohio",39059,"Guernsey County",13407,4577,18230,8830,0.735436094349973,0.251069665386725,0.484366428963247
"Ohio",39061,"Hamilton County",177886,246266,430929,-68380,0.412796539569163,0.57147697184455,-0.158680432275386
"Ohio",39063,"Hancock County",26310,11757,38771,14553,0.678599984524516,0.303242113951149,0.375357870573367
"Ohio",39065,"Hardin County",9949,3062,13247,6887,0.751037970861327,0.231146674718804,0.519891296142523
"Ohio",39067,"Harrison County",5792,1768,7655,4024,0.756629653821032,0.230960156760287,0.525669497060745
"Ohio",39069,"Henry County",10479,4062,14764,6417,0.709767000812788,0.275128691411542,0.434638309401246
"Ohio",39071,"Highland County",15678,3799,19676,11879,0.796808294368774,0.193077861353934,0.60373043301484
"Ohio",39073,"Hocking County",9737,3880,13824,5857,0.70435474537037,0.280671296296296,0.423683449074074
"Ohio",39075,"Holmes County",10796,1994,12947,8802,0.833861126129605,0.15401251255117,0.679848613578435
"Ohio",39077,"Huron County",18956,7759,27190,11197,0.697168076498713,0.285362265538801,0.411805810959912
"Ohio",39079,"Jackson County",11309,3311,14794,7998,0.764431526294444,0.223806948763012,0.540624577531432
"Ohio",39081,"Jefferson County",22828,10018,33362,12810,0.684251543672442,0.300281757688388,0.383969785984054
"Ohio",39083,"Knox County",22340,8589,31398,13751,0.711510287279445,0.273552455570419,0.437957831709026
"Ohio",39085,"Lake County",73278,55514,130509,17764,0.561478518722847,0.425365300477362,0.136113218245485
"Ohio",39087,"Lawrence County",20306,7489,28127,12817,0.721939773171686,0.266256621751342,0.455683151420343
"Ohio",39089,"Licking County",59514,33055,94210,26459,0.63171637830379,0.35086508863178,0.280851289672009
"Ohio",39091,"Logan County",17964,5055,23368,12909,0.768743580965423,0.216321465251626,0.552422115713797
"Ohio",39093,"Lorain County",79520,75667,157437,3853,0.505090925258992,0.48061764388295,0.0244732813760424
"Ohio",39095,"Lucas County",81763,115411,200623,-33648,0.407545495780643,0.575263055581863,-0.167717559801219
"Ohio",39097,"Madison County",13835,5698,19855,8137,0.696801813145303,0.286980609418283,0.409821203727021
"Ohio",39099,"Mahoning County",59903,57641,118966,2262,0.503530420456265,0.484516584570381,0.0190138358858834
"Ohio",39101,"Marion County",19023,8269,27818,10754,0.683837802861457,0.297253576820764,0.386584226040693
"Ohio",39103,"Medina County",64598,39800,105825,24798,0.610422867942358,0.376092605716986,0.234330262225372
"Ohio",39105,"Meigs County",8316,2492,10951,5824,0.75938270477582,0.227559127020363,0.531823577755456
"Ohio",39107,"Mercer County",19452,4030,23761,15422,0.818652413618955,0.169605656327596,0.64904675729136
"Ohio",39109,"Miami County",41371,15663,57972,25708,0.713637618160491,0.270182156903333,0.443455461257159
"Ohio",39111,"Monroe County",5463,1605,7148,3858,0.764269725797426,0.224538332400672,0.539731393396754
"Ohio",39113,"Montgomery County",129034,135064,268505,-6030,0.480564607735424,0.503022290087708,-0.0224576823522839
"Ohio",39115,"Morgan County",5041,1725,6847,3316,0.736234847378414,0.25193515408208,0.484299693296334
"Ohio",39117,"Morrow County",14077,4048,18457,10029,0.762691661700168,0.219320582976648,0.54337107872352
"Ohio",39119,"Muskingum County",27867,11971,40465,15896,0.688669220313851,0.295835907574447,0.392833312739404
"Ohio",39121,"Noble County",5135,1170,6343,3965,0.809553838877503,0.184455305060697,0.625098533816806
"Ohio",39123,"Ottawa County",14628,9008,24007,5620,0.609322281001375,0.375223893031199,0.234098387970175
"Ohio",39125,"Paulding County",7086,2213,9467,4873,0.748494771310869,0.233759374669906,0.514735396640963
"Ohio",39127,"Perry County",12357,4098,16675,8259,0.741049475262369,0.24575712143928,0.495292353823089
"Ohio",39129,"Pickaway County",20593,7304,28271,13289,0.728414276113332,0.258356619857805,0.470057656255527
"Ohio",39131,"Pike County",9157,3110,12412,6047,0.737753786658073,0.250563970351273,0.4871898163068
"Ohio",39133,"Portage County",45990,35661,82872,10329,0.554952215464813,0.430314219519259,0.124637995945555
"Ohio",39135,"Preble County",17022,4493,21809,12529,0.780503461873538,0.206015865009858,0.57448759686368
"Ohio",39137,"Putnam County",16412,3195,19921,13217,0.823854224185533,0.160383514883791,0.663470709301742
"Ohio",39139,"Richland County",41472,17640,59975,23832,0.691488120050021,0.294122551062943,0.397365568987078
"Ohio",39141,"Ross County",22278,10557,33299,11721,0.669029099972972,0.317036547644073,0.351992552328899
"Ohio",39143,"Sandusky County",18896,10596,30074,8300,0.628316818514331,0.352330917071224,0.275985901443107
"Ohio",39145,"Scioto County",22609,9080,32047,13529,0.705495054139233,0.283333853402815,0.422161200736418
"Ohio",39147,"Seneca County",17086,8266,25810,8820,0.661991476172026,0.320263463773731,0.341728012398295
"Ohio",39149,"Shelby County",20422,4465,25258,15957,0.808535909414839,0.176775675033653,0.631760234381186
"Ohio",39151,"Stark County",111097,75904,189879,35193,0.585093664912918,0.399749314036834,0.185344350876084
"Ohio",39153,"Summit County",124833,151668,280473,-26835,0.445080275106695,0.540757933918773,-0.0956776588120781
"Ohio",39155,"Trumbull County",55194,44519,101001,10675,0.546469836932308,0.440777814081049,0.105692022851259
"Ohio",39157,"Tuscarawas County",30458,12889,44015,17569,0.691991366579575,0.292831989094627,0.399159377484948
"Ohio",39159,"Union County",21669,11141,33445,10528,0.647899536552549,0.333114067872627,0.314785468679922
"Ohio",39161,"Van Wert County",11650,3067,14965,8583,0.778483127297026,0.204944871366522,0.573538255930504
"Ohio",39163,"Vinton County",4632,1331,6030,3301,0.7681592039801,0.220729684908789,0.54742951907131
"Ohio",39165,"Warren County",87988,46069,136100,41919,0.646495224099927,0.338493754592212,0.308001469507715
"Ohio",39167,"Washington County",22307,9243,32031,13064,0.696419094002685,0.288564203427929,0.407854890574756
"Ohio",39169,"Wayne County",36759,16660,54283,20099,0.677173332350828,0.306910082346223,0.370263250004606
"Ohio",39171,"Williams County",13452,4842,18651,8610,0.721248190445553,0.259610744732186,0.461637445713367
"Ohio",39173,"Wood County",35757,30617,67597,5140,0.528973179283104,0.452934301818128,0.0760388774649762
"Ohio",39175,"Wyandot County",8462,2733,11390,5729,0.742932396839333,0.239947322212467,0.502985074626866
"Oklahoma",40001,"Adair County",5585,1387,7108,4198,0.785734383792909,0.195132245357344,0.590602138435566
"Oklahoma",40003,"Alfalfa County",1978,232,2262,1746,0.874447391688771,0.102564102564103,0.771883289124668
"Oklahoma",40005,"Atoka County",4557,765,5389,3792,0.845611430692151,0.141955835962145,0.703655594730006
"Oklahoma",40007,"Beaver County",1968,190,2178,1778,0.903581267217631,0.0872359963269054,0.816345270890726
"Oklahoma",40009,"Beckham County",6767,1048,7948,5719,0.85140915953699,0.131857070961248,0.719552088575742
"Oklahoma",40011,"Blaine County",3136,688,3901,2448,0.803896436811074,0.176365034606511,0.627531402204563
"Oklahoma",40013,"Bryan County",12344,3323,15976,9021,0.772658988482724,0.207999499248873,0.564659489233851
"Oklahoma",40015,"Caddo County",7013,2670,9859,4343,0.711329749467492,0.270818541434223,0.440511208033269
"Oklahoma",40017,"Canadian County",43550,16742,61940,26808,0.703099773974814,0.270293832741363,0.432805941233452
"Oklahoma",40019,"Carter County",14699,4470,19479,10229,0.754607526053699,0.229477899276144,0.525129626777555
"Oklahoma",40021,"Cherokee County",11223,6027,17714,5196,0.633566670430168,0.340239358699334,0.293327311730834
"Oklahoma",40023,"Choctaw County",4698,1082,5832,3616,0.805555555555556,0.185528120713306,0.62002743484225
"Oklahoma",40025,"Cimarron County",970,70,1054,900,0.920303605313093,0.0664136622390892,0.853889943074004
"Oklahoma",40027,"Cleveland County",66677,49827,119778,16850,0.556671508958239,0.415994589991484,0.140676918966755
"Oklahoma",40029,"Coal County",2091,374,2524,1717,0.828446909667195,0.148177496038035,0.68026941362916
"Oklahoma",40031,"Comanche County",20905,13747,35631,7158,0.586708203530633,0.38581572226432,0.200892481266313
"Oklahoma",40033,"Cotton County",2117,393,2572,1724,0.823094867807154,0.152799377916019,0.670295489891135
"Oklahoma",40035,"Craig County",4686,1217,6032,3469,0.77685676392573,0.201757294429708,0.575099469496021
"Oklahoma",40037,"Creek County",23294,6577,30505,16717,0.763612522537289,0.21560399934437,0.548008523192919
"Oklahoma",40039,"Custer County",8060,2369,10691,5691,0.753905153867739,0.22158825180058,0.532316902067159
"Oklahoma",40041,"Delaware County",13557,3472,17245,10085,0.786140910408814,0.201333719918817,0.584807190489997
"Oklahoma",40043,"Dewey County",2124,214,2359,1910,0.9003815175922,0.0907164052564646,0.809665112335735
"Oklahoma",40045,"Ellis County",1688,162,1873,1526,0.901227976508276,0.0864922584089696,0.814735718099306
"Oklahoma",40047,"Garfield County",16970,4919,22430,12051,0.756576014266607,0.219304502897905,0.537271511368703
"Oklahoma",40049,"Garvin County",8878,1865,10922,7013,0.812854788500275,0.170756271745102,0.642098516755173
"Oklahoma",40051,"Grady County",18538,4144,23101,14394,0.802476083286438,0.179386173758712,0.623089909527726
"Oklahoma",40053,"Grant County",1916,280,2226,1636,0.8607367475292,0.125786163522013,0.734950584007188
"Oklahoma",40055,"Greer County",1605,328,1973,1277,0.813482007095793,0.166244298023315,0.647237709072478
"Oklahoma",40057,"Harmon County",747,177,933,570,0.80064308681672,0.189710610932476,0.610932475884244
"Oklahoma",40059,"Harper County",1327,136,1487,1191,0.892400806993948,0.0914593140551446,0.800941492938803
"Oklahoma",40061,"Haskell County",4165,783,5014,3382,0.830674112485042,0.156162744315915,0.674511368169126
"Oklahoma",40063,"Hughes County",3875,919,4857,2956,0.797817582870084,0.189211447395512,0.608606135474573
"Oklahoma",40065,"Jackson County",6392,1646,8221,4746,0.777520982848802,0.200218951465758,0.577302031383043
"Oklahoma",40067,"Jefferson County",2026,319,2385,1707,0.849475890985325,0.133752620545073,0.715723270440252
"Oklahoma",40069,"Johnston County",3441,738,4251,2703,0.809456598447424,0.173606210303458,0.635850388143966
"Oklahoma",40071,"Kay County",12834,4040,17249,8794,0.744043132935243,0.234216476317468,0.509826656617775
"Oklahoma",40073,"Kingfisher County",5521,854,6465,4667,0.853982985305491,0.132095901005414,0.721887084300077
"Oklahoma",40075,"Kiowa County",2673,699,3427,1974,0.779982491975489,0.20396848555588,0.576014006419609
"Oklahoma",40077,"Latimer County",3437,762,4249,2675,0.808896210873147,0.179336314426924,0.629559896446223
"Oklahoma",40079,"Le Flore County",15213,3299,18805,11914,0.80898697155012,0.17543206593991,0.63355490561021
"Oklahoma",40081,"Lincoln County",12013,2609,14888,9404,0.806891456206341,0.175241805480924,0.631649650725416
"Oklahoma",40083,"Logan County",15608,5455,21574,10153,0.723463428200612,0.252850653564476,0.470612774636136
"Oklahoma",40085,"Love County",3305,711,4076,2594,0.810843964671246,0.174435721295388,0.636408243375859
"Oklahoma",40087,"McClain County",15295,3582,19236,11713,0.795123726346434,0.186213349968808,0.608910376377625
"Oklahoma",40089,"McCurtain County",9485,1858,11467,7627,0.827156187320136,0.162030173541467,0.665126013778669
"Oklahoma",40091,"McIntosh County",6172,2031,8335,4141,0.740491901619676,0.243671265746851,0.496820635872825
"Oklahoma",40093,"Major County",3084,320,3467,2764,0.88952985289876,0.0922988174214018,0.797231035477358
"Oklahoma",40095,"Marshall County",4891,1100,6064,3791,0.806563324538259,0.181398416886544,0.625164907651715
"Oklahoma",40097,"Mayes County",12749,3581,16626,9168,0.766811018886082,0.215385540719355,0.551425478166727
"Oklahoma",40099,"Murray County",4612,1156,5894,3456,0.782490668476417,0.196131659314557,0.58635900916186
"Oklahoma",40101,"Muskogee County",16526,8027,25081,8499,0.658905147322675,0.320043060484032,0.338862086838643
"Oklahoma",40103,"Noble County",3821,1003,4938,2818,0.77379505872823,0.203118671526934,0.570676387201296
"Oklahoma",40105,"Nowata County",3610,712,4391,2898,0.82213618765657,0.162149851969939,0.659986335686632
"Oklahoma",40107,"Okfuskee County",3058,896,4038,2162,0.757305596830114,0.221892025755324,0.53541357107479
"Oklahoma",40109,"Oklahoma County",145050,141724,294740,3326,0.492128655764403,0.480844133812852,0.0112845219515505
"Oklahoma",40111,"Okmulgee County",9668,4357,14313,5311,0.675469852581569,0.304408579612939,0.37106127296863
"Oklahoma",40113,"Osage County",14121,6002,20538,8119,0.687554776511832,0.292238776901354,0.395315999610478
"Oklahoma",40115,"Ottawa County",8545,2686,11438,5859,0.747071166287813,0.234831264207029,0.512239902080783
"Oklahoma",40117,"Pawnee County",5267,1363,6786,3904,0.776156793398173,0.200854700854701,0.575302092543472
"Oklahoma",40119,"Payne County",17813,10904,29643,6909,0.600917585939345,0.367844010390311,0.233073575549033
"Oklahoma",40121,"Pittsburg County",13851,3768,17924,10083,0.772762776166034,0.210220932827494,0.56254184333854
"Oklahoma",40123,"Pontotoc County",10805,4117,15320,6688,0.705287206266319,0.268733681462141,0.436553524804178
"Oklahoma",40125,"Pottawatomie County",20240,7275,28185,12965,0.71811247117261,0.258116019159127,0.459996452013482
"Oklahoma",40127,"Pushmataha County",4016,668,4739,3348,0.847436167967926,0.140958008018569,0.706478159949356
"Oklahoma",40129,"Roger Mills County",1629,168,1834,1461,0.888222464558342,0.0916030534351145,0.796619411123228
"Oklahoma",40131,"Rogers County",34031,9589,44553,24442,0.763831840729019,0.215226808520189,0.54860503220883
"Oklahoma",40133,"Seminole County",6011,2150,8337,3861,0.721002758786134,0.257886529926832,0.463116228859302
"Oklahoma",40135,"Sequoyah County",12113,3035,15386,9078,0.78727414532692,0.197257246847784,0.590016898479137
"Oklahoma",40137,"Stephens County",15560,3154,19057,12406,0.816497874796663,0.165503489531406,0.650994385265257
"Oklahoma",40139,"Texas County",4505,894,5521,3611,0.81597536678138,0.161927187103786,0.654048179677595
"Oklahoma",40141,"Tillman County",2076,597,2708,1479,0.766617429837518,0.220457902511078,0.54615952732644
"Oklahoma",40143,"Tulsa County",150574,108996,266678,41578,0.56462850328861,0.408717629500746,0.155910873787864
"Oklahoma",40145,"Wagoner County",26165,8464,35338,17701,0.740421076461599,0.239515535683966,0.500905540777633
"Oklahoma",40147,"Washington County",17076,5790,23501,11286,0.726607378409429,0.246372494787456,0.480234883621974
"Oklahoma",40149,"Washita County",4086,598,4777,3488,0.855348545111995,0.125183169353151,0.730165375758844
"Oklahoma",40151,"Woods County",2993,591,3678,2402,0.813757476889614,0.16068515497553,0.653072321914084
"Oklahoma",40153,"Woodward County",6611,1005,7785,5606,0.849197174052665,0.129094412331407,0.720102761721259
"Oregon",41001,"Baker County",7352,2346,9932,5006,0.740233588401128,0.236206202174789,0.504027386226339
"Oregon",41003,"Benton County",14878,35827,52799,-20949,0.281785639879543,0.678554518077994,-0.396768878198451
"Oregon",41005,"Clackamas County",110509,139043,257679,-28534,0.42886304277803,0.539597716538794,-0.110734673760764
"Oregon",41007,"Clatsop County",10218,12916,23910,-2698,0.427352572145546,0.540192388122125,-0.112839815976579
"Oregon",41009,"Columbia County",17150,13835,32221,3315,0.532261568542255,0.429378355730735,0.10288321281152
"Oregon",41011,"Coos County",21829,14243,37075,7586,0.588779501011463,0.384167228590695,0.204612272420769
"Oregon",41013,"Crook County",11287,3801,15448,7486,0.730644743656137,0.246051268772657,0.48459347488348
"Oregon",41015,"Curry County",8484,6058,14925,2426,0.568442211055276,0.405896147403685,0.162546063651591
"Oregon",41017,"Deschutes County",55646,65962,125234,-10316,0.444336202628679,0.526709998882093,-0.0823737962534136
"Oregon",41019,"Douglas County",43298,19160,64349,24138,0.672862049138293,0.297751324806912,0.37511072433138
"Oregon",41021,"Gilliam County",834,324,1178,510,0.707979626485569,0.275042444821732,0.432937181663837
"Oregon",41023,"Grant County",3545,929,4596,2616,0.771322889469104,0.20213228894691,0.569190600522193
"Oregon",41025,"Harney County",3475,894,4481,2581,0.775496540950681,0.199509038161125,0.575987502789556
"Oregon",41027,"Hood River County",3955,8764,13090,-4809,0.302139037433155,0.66951871657754,-0.367379679144385
"Oregon",41029,"Jackson County",63869,59478,127165,4391,0.502252978413872,0.467723036999174,0.0345299414146975
"Oregon",41031,"Jefferson County",7189,4393,11913,2796,0.603458406782507,0.368756820280366,0.23470158650214
"Oregon",41033,"Josephine County",31751,18451,51641,13300,0.614840920973645,0.357293623283825,0.25754729768982
"Oregon",41035,"Klamath County",25308,10388,36726,14920,0.689103087730763,0.282851385939117,0.406251701791646
"Oregon",41037,"Lake County",3470,792,4363,2678,0.795324318129727,0.181526472610589,0.613797845519138
"Oregon",41039,"Lane County",80336,134366,222253,-54030,0.361461937521653,0.604563267987384,-0.243101330465731
"Oregon",41041,"Lincoln County",12460,17385,30726,-4925,0.405519755256135,0.56580745948057,-0.160287704224435
"Oregon",41043,"Linn County",43486,26512,72640,16974,0.598650881057269,0.364977973568282,0.233672907488987
"Oregon",41045,"Malheur County",8187,3260,11804,4927,0.693578447983734,0.276177566926466,0.417400881057269
"Oregon",41047,"Marion County",79002,80872,165534,-1870,0.477255427887926,0.48855220075634,-0.0112967728684137
"Oregon",41049,"Morrow County",3586,1371,5118,2215,0.700664322000782,0.267878077373974,0.432786244626807
"Oregon",41051,"Multnomah County",82995,367249,463659,-284254,0.17900008411354,0.792067014767318,-0.613066930653778
"Oregon",41053,"Polk County",23732,22917,48291,815,0.491437327866476,0.474560477107536,0.0168768507589406
"Oregon",41055,"Sherman County",921,260,1208,661,0.762417218543046,0.21523178807947,0.547185430463576
"Oregon",41057,"Tillamook County",8354,8066,16888,288,0.494670772145902,0.47761724301279,0.0170535291331123
"Oregon",41059,"Umatilla County",21270,10707,33038,10563,0.643804104364671,0.324081360857195,0.319722743507476
"Oregon",41061,"Union County",10298,4254,14944,6044,0.689105995717345,0.284662740899358,0.404443254817987
"Oregon",41063,"Wallowa County",3404,1625,5149,1779,0.661099242571373,0.31559526121577,0.345503981355603
"Oregon",41065,"Wasco County",7035,6604,14130,431,0.497876857749469,0.467374380750177,0.0305024769992923
"Oregon",41067,"Washington County",99073,209940,320326,-110867,0.30928803781148,0.655394816530659,-0.34610677871918
"Oregon",41069,"Wheeler County",711,217,965,494,0.736787564766839,0.224870466321244,0.511917098445596
"Oregon",41071,"Yamhill County",29551,27174,58923,2377,0.501518931486856,0.461178147752151,0.0403407837347047
"Pennsylvania",42001,"Adams County",37523,18207,56714,19316,0.661617942659661,0.321031843989138,0.340586098670522
"Pennsylvania",42003,"Allegheny County",282913,430759,724800,-147846,0.390332505518764,0.594314293598234,-0.20398178807947
"Pennsylvania",42005,"Armstrong County",27489,8457,36370,19032,0.755815232334341,0.232526807808633,0.523288424525708
"Pennsylvania",42007,"Beaver County",54759,38122,94122,16637,0.581787467329636,0.405027517477317,0.176759949852319
"Pennsylvania",42009,"Bedford County",23025,4367,27574,18658,0.835025748893886,0.158373830419961,0.676651918473925
"Pennsylvania",42011,"Berks County",109736,92895,205540,16841,0.533891213389121,0.451955823683954,0.0819353897051669
"Pennsylvania",42013,"Blair County",45306,17636,63595,27670,0.712414497995125,0.277317399166601,0.435097098828524
"Pennsylvania",42015,"Bradford County",21600,8046,30159,13554,0.71620411817368,0.266786034019696,0.449418084153984
"Pennsylvania",42017,"Bucks County",187367,204712,396234,-17345,0.472869566973051,0.516644205191882,-0.0437746382188303
"Pennsylvania",42019,"Butler County",74359,37508,113305,36851,0.65627289175235,0.331035700101496,0.325237191650854
"Pennsylvania",42021,"Cambria County",48085,21730,70574,26355,0.681341570550061,0.307903760591719,0.373437809958342
"Pennsylvania",42023,"Cameron County",1771,634,2434,1137,0.727608874281019,0.260476581758422,0.467132292522597
"Pennsylvania",42025,"Carbon County",21984,11212,33629,10772,0.653721490380326,0.333402717892295,0.320318772488031
"Pennsylvania",42027,"Centre County",36372,40055,77493,-3683,0.469358522705277,0.516885396100293,-0.0475268733950163
"Pennsylvania",42029,"Chester County",128565,182372,315753,-53807,0.407169528080493,0.577578043597369,-0.170408515516876
"Pennsylvania",42031,"Clarion County",14578,4678,19493,9900,0.74785820550967,0.239983583850613,0.507874621659057
"Pennsylvania",42033,"Clearfield County",29203,9673,39496,19530,0.739391330767673,0.244910877050841,0.494480453716832
"Pennsylvania",42035,"Clinton County",11902,5502,17625,6400,0.675290780141844,0.312170212765957,0.363120567375886
"Pennsylvania",42037,"Columbia County",20098,10532,31171,9566,0.644765968368034,0.337878155978313,0.306887812389721
"Pennsylvania",42039,"Crawford County",28559,12924,42004,15635,0.679911437005999,0.30768498238263,0.372226454623369
"Pennsylvania",42041,"Cumberland County",77212,62245,141595,14967,0.545301740880681,0.439598855891804,0.105702884988877
"Pennsylvania",42043,"Dauphin County",66408,78983,147368,-12575,0.450627001791434,0.535957602736008,-0.0853306009445741
"Pennsylvania",42045,"Delaware County",118532,206423,329006,-87891,0.360273064928907,0.62741408971265,-0.267141024783743
"Pennsylvania",42047,"Elk County",12140,4522,16906,7618,0.718088252691352,0.267479001537916,0.450609251153437
"Pennsylvania",42049,"Erie County",66869,68286,137083,-1417,0.487799362430061,0.498136165680646,-0.0103368032505854
"Pennsylvania",42051,"Fayette County",41227,20444,62139,20783,0.663464169040377,0.329004329004329,0.334459840036048
"Pennsylvania",42053,"Forest County",1882,728,2646,1154,0.711262282690854,0.275132275132275,0.436130007558579
"Pennsylvania",42055,"Franklin County",57245,22422,80783,34823,0.70862681504772,0.277558397187527,0.431068417860193
"Pennsylvania",42057,"Fulton County",6824,1085,7977,5739,0.855459445906983,0.136016046132631,0.719443399774351
"Pennsylvania",42059,"Greene County",12579,4911,17669,7668,0.711924840115456,0.277944422434773,0.433980417680684
"Pennsylvania",42061,"Huntingdon County",17061,5445,22792,11616,0.748552123552124,0.238899613899614,0.50965250965251
"Pennsylvania",42063,"Indiana County",28089,12634,41198,15455,0.681804941987475,0.306665372105442,0.375139569882033
"Pennsylvania",42065,"Jefferson County",17960,4527,22824,13433,0.786890991938311,0.198343848580442,0.588547143357869
"Pennsylvania",42067,"Juniata County",9649,2253,12043,7396,0.801212322511002,0.187079631321099,0.614132691189903
"Pennsylvania",42069,"Lackawanna County",52334,61991,115410,-9657,0.45346157178754,0.537137163157439,-0.0836755913698985
"Pennsylvania",42071,"Lancaster County",160209,115847,281375,44362,0.569378942692137,0.411717458907152,0.157661483784984
"Pennsylvania",42073,"Lawrence County",29597,15978,46076,13619,0.64235176664641,0.346774893653963,0.295576872992447
"Pennsylvania",42075,"Lebanon County",46731,23932,71858,22799,0.650324250605361,0.33304572907679,0.31727852152857
"Pennsylvania",42077,"Lehigh County",84259,98288,184713,-14029,0.456161721156605,0.532111979124371,-0.0759502579677662
"Pennsylvania",42079,"Luzerne County",86929,64873,153321,22056,0.566973865289165,0.423118816078685,0.14385504921048
"Pennsylvania",42081,"Lycoming County",41462,16971,59254,24491,0.699733351334931,0.286411043980153,0.413322307354778
"Pennsylvania",42083,"McKean County",14083,5098,19466,8985,0.723466557073872,0.261892530566115,0.461574026507757
"Pennsylvania",42085,"Mercer County",36143,21067,57954,15076,0.623649791213721,0.363512440901405,0.260137350312317
"Pennsylvania",42087,"Mifflin County",16670,4603,21502,12067,0.775276718444796,0.214073109478188,0.561203608966608
"Pennsylvania",42089,"Monroe County",38726,44060,83829,-5334,0.46196423671999,0.525593768266352,-0.0636295315463623
"Pennsylvania",42091,"Montgomery County",185460,319511,510157,-134051,0.363535147023367,0.626299354904471,-0.262764207881103
"Pennsylvania",42093,"Montour County",5844,3771,9817,2073,0.595293877966792,0.384129571152083,0.211164306814709
"Pennsylvania",42095,"Northampton County",83854,85087,171399,-1233,0.489232725978565,0.496426466898873,-0.00719374092030872
"Pennsylvania",42097,"Northumberland County",28952,12677,42283,16275,0.684719627273372,0.299813163682804,0.384906463590568
"Pennsylvania",42099,"Perry County",18293,5950,24652,12343,0.742049326626643,0.241359727405484,0.500689599221159
"Pennsylvania",42101,"Philadelphia County",132740,603790,741377,-471050,0.179045209117628,0.814416956555167,-0.635371747437539
"Pennsylvania",42103,"Pike County",19213,13019,32554,6194,0.590188609694661,0.399920132702586,0.190268476992075
"Pennsylvania",42105,"Potter County",7239,1726,9064,5513,0.798654015887026,0.190423654015887,0.608230361871139
"Pennsylvania",42107,"Schuylkill County",48871,20727,70603,28144,0.692194382674957,0.293571094712689,0.398623287962268
"Pennsylvania",42109,"Snyder County",13983,4910,19140,9073,0.730564263322884,0.256530825496343,0.474033437826541
"Pennsylvania",42111,"Somerset County",31466,8654,40543,22812,0.77611424906889,0.213452383888711,0.562661865180179
"Pennsylvania",42113,"Sullivan County",2619,921,3595,1698,0.728511821974965,0.256189151599444,0.472322670375522
"Pennsylvania",42115,"Susquehanna County",15207,6236,21752,8971,0.699108127988231,0.286686281721221,0.41242184626701
"Pennsylvania",42117,"Tioga County",15742,4955,21075,10787,0.746951364175564,0.235112692763938,0.511838671411625
"Pennsylvania",42119,"Union County",12356,7475,20115,4881,0.614267959234402,0.371613223962217,0.242654735272185
"Pennsylvania",42121,"Venango County",18569,7585,26528,10984,0.69997738238842,0.285924306393245,0.414053075995175
"Pennsylvania",42123,"Warren County",14237,6066,20650,8171,0.689443099273608,0.293753026634383,0.395690072639225
"Pennsylvania",42125,"Washington County",72080,45088,118478,26992,0.608382990935026,0.38056010398555,0.227822886949476
"Pennsylvania",42127,"Wayne County",18637,9191,28089,9446,0.663498166542063,0.327209939834099,0.336288226707964
"Pennsylvania",42129,"Westmoreland County",130218,72129,205183,58089,0.634643220929609,0.351534971220813,0.283108249708797
"Pennsylvania",42131,"Wyoming County",9936,4704,14858,5232,0.668730650154799,0.316597119396958,0.352133530757841
"Pennsylvania",42133,"York County",146733,88114,238471,58619,0.615307521669301,0.369495661946316,0.245811859722985
"Rhode Island",44001,"Bristol County",9745,18050,28415,-8305,0.342952665845504,0.635227872602499,-0.292275206756995
"Rhode Island",44003,"Kent County",42001,49113,93093,-7112,0.451172483430548,0.52756920498856,-0.0763967215580119
"Rhode Island",44005,"Newport County",15722,29486,46148,-13764,0.340686486955014,0.638944266273728,-0.298257779318714
"Rhode Island",44007,"Providence County",102551,165012,272667,-62461,0.376103452196269,0.605177744281486,-0.229074292085217
"Rhode Island",44009,"Washington County",29818,44549,76060,-14731,0.392032605837497,0.585708651064949,-0.193676045227452
"South Carolina",45001,"Abbeville County",8215,4101,12433,4114,0.660741574841149,0.329847985200676,0.330893589640473
"South Carolina",45003,"Aiken County",51589,32275,85185,19314,0.60561131654634,0.378881258437518,0.226730058108822
"South Carolina",45005,"Allendale County",835,2718,3593,-1883,0.232396326189814,0.756470915669357,-0.524074589479544
"South Carolina",45007,"Anderson County",67565,27169,96093,40396,0.703120934927622,0.282736515667114,0.420384419260508
"South Carolina",45009,"Bamberg County",2417,4010,6482,-1593,0.372878741129281,0.618636223387843,-0.245757482258562
"South Carolina",45011,"Barnwell County",5492,4720,10321,772,0.532118980718923,0.457320027129154,0.0747989535897685
"South Carolina",45013,"Beaufort County",53194,43419,97835,9775,0.543711350743599,0.443798231716666,0.0999131190269331
"South Carolina",45015,"Berkeley County",57397,45223,104458,12174,0.549474429914415,0.432929981427942,0.116544448486473
"South Carolina",45017,"Calhoun County",4305,3905,8291,400,0.519237727656495,0.470992642624533,0.0482450850319624
"South Carolina",45019,"Charleston County",93297,121485,218857,-28188,0.42629205371544,0.555088482433735,-0.128796428718296
"South Carolina",45021,"Cherokee County",18043,6983,25270,11060,0.714008705975465,0.276335575781559,0.437673130193906
"South Carolina",45023,"Chester County",8660,6941,15757,1719,0.549597004505934,0.440502633750079,0.109094370755855
"South Carolina",45025,"Chesterfield County",11297,7431,18876,3866,0.598484848484849,0.393674507310871,0.204810341173978
"South Carolina",45027,"Clarendon County",8361,8250,16733,111,0.49967130819339,0.49303770991454,0.00663359827885013
"South Carolina",45029,"Colleton County",10440,8602,19283,1838,0.541409531711871,0.446092413006275,0.0953171187055956
"South Carolina",45031,"Darlington County",16832,15220,32417,1612,0.519233735385754,0.469506740290588,0.0497269950951661
"South Carolina",45033,"Dillon County",6582,6436,13101,146,0.502404396610946,0.49126020914434,0.0111441874666056
"South Carolina",45035,"Dorchester County",41913,33824,77278,8089,0.542366520872693,0.437692486865602,0.104674034007091
"South Carolina",45037,"Edgefield County",8184,4953,13304,3231,0.615153337342153,0.372294046903187,0.242859290438966
"South Carolina",45039,"Fairfield County",4625,7382,12136,-2757,0.38109756097561,0.608272907053395,-0.227175346077785
"South Carolina",45041,"Florence County",32615,31153,64510,1462,0.505580530150364,0.482917377150829,0.022663152999535
"South Carolina",45043,"Georgetown County",20487,15822,36668,4665,0.558716046689211,0.431493400239991,0.12722264644922
"South Carolina",45045,"Greenville County",150021,103030,258155,46991,0.581127617129244,0.399101315101393,0.182026302027852
"South Carolina",45047,"Greenwood County",19431,12145,32006,7286,0.607104917827907,0.379460101231019,0.227644816596888
"South Carolina",45049,"Hampton County",3906,5323,9305,-1417,0.419774314884471,0.572058033315422,-0.152283718430951
"South Carolina",45051,"Horry County",118821,59180,179744,59641,0.661056836389532,0.329246038810753,0.331810797578779
"South Carolina",45053,"Jasper County",7078,7185,14394,-107,0.491732666388773,0.499166319299708,-0.00743365291093512
"South Carolina",45055,"Kershaw County",20471,12699,33629,7772,0.608730559933391,0.377620506110797,0.231110053822594
"South Carolina",45057,"Lancaster County",30312,18937,49868,11375,0.607844710034491,0.379742520253469,0.228102189781022
"South Carolina",45059,"Laurens County",20004,10159,30488,9845,0.656127000787195,0.333213067436368,0.322913933350827
"South Carolina",45061,"Lee County",3008,5329,8431,-2321,0.356778555331515,0.632072114814376,-0.275293559482861
"South Carolina",45063,"Lexington County",92817,49301,144568,43516,0.642030048143434,0.34102290963422,0.301007138509214
"South Carolina",45065,"McCormick County",2958,2687,5697,271,0.519220642443391,0.471651746533263,0.0475688959101281
"South Carolina",45067,"Marion County",5711,8872,14704,-3161,0.388397714907508,0.603373231773667,-0.214975516866159
"South Carolina",45069,"Marlboro County",5044,6290,11446,-1246,0.440677966101695,0.549536956141884,-0.108858990040189
"South Carolina",45071,"Newberry County",11443,6958,18631,4485,0.614191401427728,0.373463582201707,0.240727819226021
"South Carolina",45073,"Oconee County",29698,10414,40668,19284,0.730254745746041,0.256073571358316,0.474181174387725
"South Carolina",45075,"Orangeburg County",13603,27295,41205,-13692,0.330129838611819,0.66241960927072,-0.332289770658901
"South Carolina",45077,"Pickens County",42907,13645,57546,29262,0.745612205887464,0.237114656101206,0.508497549786258
"South Carolina",45079,"Richland County",58313,132570,193822,-74257,0.300858519672689,0.683978082983356,-0.383119563310666
"South Carolina",45081,"Saluda County",6210,2963,9274,3247,0.669613974552512,0.319495363381497,0.350118611171016
"South Carolina",45083,"Spartanburg County",93560,52926,148655,40634,0.629376744811813,0.356032424069153,0.273344320742659
"South Carolina",45085,"Sumter County",21000,27379,48920,-6379,0.429272281275552,0.559668847097302,-0.13039656582175
"South Carolina",45087,"Union County",8183,4935,13257,3248,0.617258806668175,0.372256166553519,0.245002640114656
"South Carolina",45089,"Williamsburg County",5532,10289,15985,-4757,0.346074444791993,0.643665936815765,-0.297591492023772
"South Carolina",45091,"York County",82727,59008,144050,23719,0.574293648038875,0.409635543214162,0.164658104824714
"South Dakota",46003,"Aurora County",1052,317,1405,735,0.748754448398577,0.225622775800712,0.523131672597865
"South Dakota",46005,"Beadle County",4808,2107,7081,2701,0.679000141222991,0.297556842253919,0.381443298969072
"South Dakota",46007,"Bennett County",694,466,1183,228,0.586644125105664,0.393913778529163,0.1927303465765
"South Dakota",46009,"Bon Homme County",2235,721,3001,1514,0.744751749416861,0.240253248917028,0.504498500499833
"South Dakota",46011,"Brookings County",8000,6110,14567,1890,0.549186517470996,0.419441202718473,0.129745314752523
"South Dakota",46013,"Brown County",10580,6538,17547,4042,0.602952071579187,0.372599304724454,0.230352766854733
"South Dakota",46015,"Brule County",1750,673,2490,1077,0.70281124497992,0.270281124497992,0.432530120481928
"South Dakota",46017,"Buffalo County",183,352,549,-169,0.333333333333333,0.641165755919854,-0.307832422586521
"South Dakota",46019,"Butte County",3731,939,4802,2792,0.776967930029155,0.195543523531862,0.581424406497293
"South Dakota",46021,"Campbell County",747,117,873,630,0.855670103092783,0.134020618556701,0.721649484536082
"South Dakota",46023,"Charles Mix County",2552,1177,3783,1375,0.674596880782448,0.311128733809146,0.363468146973302
"South Dakota",46025,"Clark County",1373,437,1850,936,0.742162162162162,0.236216216216216,0.505945945945946
"South Dakota",46027,"Clay County",2456,3083,5698,-627,0.431028431028431,0.541067041067041,-0.11003861003861
"South Dakota",46029,"Codington County",8958,3837,13161,5121,0.680647367221336,0.29154319580579,0.389104171415546
"South Dakota",46031,"Corson County",647,622,1283,25,0.504286827747467,0.484801247077163,0.019485580670304
"South Dakota",46033,"Custer County",3852,1522,5494,2330,0.701128503822352,0.277029486712778,0.424099017109574
"South Dakota",46035,"Davison County",5613,2648,8454,2965,0.663946061036196,0.313224509108115,0.350721551928081
"South Dakota",46037,"Day County",1869,1052,2964,817,0.630566801619433,0.354925775978408,0.275641025641026
"South Dakota",46039,"Deuel County",1699,609,2350,1090,0.722978723404255,0.259148936170213,0.463829787234043
"South Dakota",46041,"Dewey County",790,1131,1966,-341,0.401831129196338,0.57527975584944,-0.173448626653103
"South Dakota",46043,"Douglas County",1468,216,1707,1252,0.859988283538371,0.126537785588752,0.733450497949619
"South Dakota",46045,"Edmunds County",1538,417,1985,1121,0.774811083123426,0.21007556675063,0.564735516372796
"South Dakota",46047,"Fall River County",2878,1053,4042,1825,0.712023750618506,0.26051459673429,0.451509153884216
"South Dakota",46049,"Faulk County",964,198,1182,766,0.815566835871404,0.16751269035533,0.648054145516074
"South Dakota",46051,"Grant County",2618,1056,3745,1562,0.699065420560748,0.281975967957276,0.417089452603471
"South Dakota",46053,"Gregory County",1771,455,2258,1316,0.784322409211692,0.201505757307352,0.58281665190434
"South Dakota",46055,"Haakon County",1026,105,1137,921,0.902374670184696,0.0923482849604222,0.810026385224274
"South Dakota",46057,"Hamlin County",2372,647,3083,1725,0.76938047356471,0.209860525462212,0.559519948102498
"South Dakota",46059,"Hand County",1433,373,1836,1060,0.780501089324619,0.203159041394336,0.577342047930283
"South Dakota",46061,"Hanson County",1793,557,2388,1236,0.750837520938023,0.233249581239531,0.517587939698492
"South Dakota",46063,"Harding County",748,49,813,699,0.920049200492005,0.0602706027060271,0.859778597785978
"South Dakota",46065,"Hughes County",5522,2953,8723,2569,0.633039092055485,0.33853032213688,0.294508769918606
"South Dakota",46067,"Hutchinson County",2944,762,3767,2182,0.781523758959384,0.202282983806743,0.579240775152641
"South Dakota",46069,"Hyde County",564,136,710,428,0.794366197183099,0.191549295774648,0.602816901408451
"South Dakota",46071,"Jackson County",738,359,1115,379,0.661883408071749,0.321973094170404,0.339910313901345
"South Dakota",46073,"Jerauld County",721,270,1006,451,0.716699801192843,0.268389662027833,0.44831013916501
"South Dakota",46075,"Jones County",498,90,599,408,0.831385642737897,0.15025041736227,0.681135225375626
"South Dakota",46077,"Kingsbury County",1904,819,2779,1085,0.685138539042821,0.294710327455919,0.390428211586902
"South Dakota",46079,"Lake County",3681,2068,5873,1613,0.626766558828537,0.352119870594245,0.274646688234293
"South Dakota",46081,"Lawrence County",8753,4537,13828,4216,0.632991032687301,0.328102400925658,0.304888631761643
"South Dakota",46083,"Lincoln County",19617,11981,32396,7636,0.60553772070626,0.369829608593654,0.235708112112606
"South Dakota",46085,"Lyman County",1042,525,1597,517,0.652473387601753,0.32874139010645,0.323731997495304
"South Dakota",46087,"McCook County",2068,769,2900,1299,0.713103448275862,0.265172413793103,0.447931034482759
"South Dakota",46089,"McPherson County",1075,222,1324,853,0.811933534743202,0.167673716012085,0.644259818731118
"South Dakota",46091,"Marshall County",1287,858,2178,429,0.590909090909091,0.393939393939394,0.196969696969697
"South Dakota",46093,"Meade County",9875,3285,13670,6590,0.722384784198976,0.240307242136064,0.482077542062912
"South Dakota",46095,"Mellette County",449,298,769,151,0.583875162548765,0.387516254876463,0.196358907672302
"South Dakota",46097,"Miner County",787,320,1138,467,0.691564147627416,0.281195079086116,0.4103690685413
"South Dakota",46099,"Minnehaha County",49249,40482,92326,8767,0.533425037367589,0.438468037172627,0.0949570001949613
"South Dakota",46101,"Moody County",1951,1179,3206,772,0.608546475358702,0.367747972551466,0.240798502807236
"South Dakota",46102,"Oglala Lakota County",297,2829,3200,-2532,0.0928125,0.8840625,-0.79125
"South Dakota",46103,"Pennington County",35063,20606,57518,14457,0.609600472895441,0.358253068604611,0.251347404290831
"South Dakota",46105,"Perkins County",1401,239,1669,1162,0.839424805272618,0.14319952067106,0.696225284601558
"South Dakota",46107,"Potter County",1139,227,1380,912,0.82536231884058,0.164492753623188,0.660869565217391
"South Dakota",46109,"Roberts County",2404,1828,4307,576,0.558161133039238,0.424425354074762,0.133735778964476
"South Dakota",46111,"Sanborn County",905,257,1185,648,0.763713080168776,0.216877637130802,0.546835443037975
"South Dakota",46115,"Spink County",2104,998,3163,1106,0.665191274106861,0.315523237432817,0.349668036674044
"South Dakota",46117,"Stanley County",1203,421,1652,782,0.728208232445521,0.254842615012107,0.473365617433414
"South Dakota",46119,"Sully County",726,185,930,541,0.780645161290323,0.198924731182796,0.581720430107527
"South Dakota",46121,"Todd County",532,1963,2539,-1431,0.209531311539976,0.773139031114612,-0.563607719574636
"South Dakota",46123,"Tripp County",2161,495,2696,1666,0.801557863501484,0.183605341246291,0.617952522255193
"South Dakota",46125,"Turner County",3290,1139,4548,2151,0.72339489885664,0.250439753737907,0.472955145118734
"South Dakota",46127,"Union County",5944,2725,8855,3219,0.671259175607002,0.307735742518351,0.36352343308865
"South Dakota",46129,"Walworth County",1966,565,2580,1401,0.762015503875969,0.218992248062016,0.543023255813953
"South Dakota",46135,"Yankton County",6581,4016,10900,2565,0.603761467889908,0.368440366972477,0.235321100917431
"South Dakota",46137,"Ziebach County",404,481,906,-77,0.445916114790287,0.530905077262693,-0.0849889624724062
"Tennessee",47001,"Anderson County",23184,11741,35570,11443,0.65178521225752,0.33008152937869,0.32170368287883
"Tennessee",47003,"Bedford County",14354,4453,19088,9901,0.75199077954736,0.233287929589271,0.518702849958089
"Tennessee",47005,"Benton County",5668,1529,7260,4139,0.780716253443526,0.210606060606061,0.570110192837466
"Tennessee",47007,"Bledsoe County",4725,971,5758,3754,0.820597429663077,0.168634942688433,0.651962486974644
"Tennessee",47009,"Blount County",47369,17932,66609,29437,0.711150144875317,0.269212869131799,0.441937275743518
"Tennessee",47011,"Bradley County",35204,9851,45865,25353,0.767556960645372,0.214782513899488,0.552774446745885
"Tennessee",47013,"Campbell County",12331,2441,14933,9890,0.825755039174982,0.163463470166745,0.662291569008237
"Tennessee",47015,"Cannon County",5190,1261,6557,3929,0.791520512429465,0.192313558029587,0.599206954399878
"Tennessee",47017,"Carroll County",9205,2559,11905,6646,0.773204535909282,0.214951700965981,0.558252834943301
"Tennessee",47019,"Carter County",19584,4529,24492,15055,0.799608035276825,0.184917524089499,0.614690511187327
"Tennessee",47021,"Cheatham County",14438,5514,20260,8924,0.712635735439289,0.272161895360316,0.440473840078973
"Tennessee",47023,"Chester County",5952,1412,7584,4540,0.784810126582278,0.186181434599156,0.598628691983122
"Tennessee",47025,"Claiborne County",10604,2202,12945,8402,0.81915797605253,0.170104287369641,0.649053688682889
"Tennessee",47027,"Clay County",2733,735,3506,1998,0.779520821448945,0.209640616086709,0.569880205362236
"Tennessee",47029,"Cocke County",12162,2533,14859,9629,0.818493842115889,0.170469075980887,0.648024766135002
"Tennessee",47031,"Coffee County",17883,5705,24282,12178,0.736471460340993,0.234947697883206,0.501523762457788
"Tennessee",47033,"Crockett County",4673,1382,6114,3291,0.764311416421328,0.226038599934576,0.538272816486752
"Tennessee",47035,"Cumberland County",25168,6728,32279,18440,0.779701973419251,0.208432727160073,0.571269246259178
"Tennessee",47037,"Davidson County",100218,199703,309658,-99485,0.323640919982691,0.644914712360088,-0.321273792377397
"Tennessee",47039,"Decatur County",4229,904,5241,3325,0.806907078801755,0.172486166762068,0.634420912039687
"Tennessee",47041,"DeKalb County",6672,1750,8513,4922,0.783742511453072,0.205567954892517,0.578174556560554
"Tennessee",47043,"Dickson County",17643,6106,24323,11537,0.725362825309378,0.251038112074991,0.474324713234387
"Tennessee",47045,"Dyer County",11768,3158,15079,8610,0.780423104980436,0.209430333576497,0.570992771403939
"Tennessee",47047,"Fayette County",15690,7027,22984,8663,0.682648799164636,0.305734423947094,0.376914375217543
"Tennessee",47049,"Fentress County",7441,1214,8729,6227,0.852445870088212,0.139076641081453,0.713369229006759
"Tennessee",47051,"Franklin County",13987,4864,19132,9123,0.731078820823751,0.254233744511813,0.476845076311938
"Tennessee",47053,"Gibson County",16259,5771,22335,10488,0.727960599955227,0.258383702708753,0.469576897246474
"Tennessee",47055,"Giles County",9784,3298,13203,6486,0.741043702188896,0.249791714004393,0.491251988184504
"Tennessee",47057,"Grainger County",8565,1467,10134,7098,0.845174659561871,0.144760213143872,0.700414446417999
"Tennessee",47059,"Greene County",22259,5199,28087,17060,0.792501869192153,0.185103428632463,0.60739844055969
"Tennessee",47061,"Grundy County",4802,988,5855,3814,0.820153714773698,0.168744662681469,0.651409052092229
"Tennessee",47063,"Hamblen County",18811,5500,24631,13311,0.763712394949454,0.223295846697251,0.540416548252203
"Tennessee",47065,"Hamilton County",92108,75522,171113,16586,0.538287564358056,0.441357465534471,0.0969300988235844
"Tennessee",47067,"Hancock County",2372,362,2744,2010,0.864431486880466,0.131924198250729,0.732507288629738
"Tennessee",47069,"Hardeman County",5760,4180,10063,1580,0.572393918314618,0.415383086554705,0.157010831759913
"Tennessee",47071,"Hardin County",9559,1775,11538,7784,0.828479805858901,0.15383948691281,0.674640318946091
"Tennessee",47073,"Hawkins County",20405,4083,24824,16322,0.821986786980342,0.164477924589107,0.657508862391234
"Tennessee",47075,"Haywood County",3343,4012,7439,-669,0.449388358650356,0.539319801048528,-0.0899314423981718
"Tennessee",47077,"Henderson County",9797,2092,12020,7705,0.815058236272879,0.174043261231281,0.641014975041597
"Tennessee",47079,"Henry County",11239,3548,15047,7691,0.746926297600851,0.235794510533661,0.51113178706719
"Tennessee",47081,"Hickman County",7577,2130,9832,5447,0.770646867371847,0.216639544344996,0.554007323026851
"Tennessee",47083,"Houston County",2718,871,3686,1847,0.737384698860553,0.236299511665762,0.501085187194791
"Tennessee",47085,"Humphreys County",6120,2017,8236,4103,0.743079164643031,0.244900437105391,0.49817872753764
"Tennessee",47087,"Jackson County",4118,1135,5323,2983,0.77362389629908,0.213225624647755,0.560398271651324
"Tennessee",47089,"Jefferson County",18651,4654,23616,13997,0.789761178861789,0.197069783197832,0.592691395663957
"Tennessee",47091,"Johnson County",6468,1246,7801,5222,0.829124471221638,0.159723112421484,0.669401358800154
"Tennessee",47093,"Knox County",124540,91422,220556,33118,0.56466384954388,0.414506973285696,0.150156876258184
"Tennessee",47095,"Lake County",1492,526,2034,966,0.733529990167158,0.258603736479843,0.474926253687316
"Tennessee",47097,"Lauderdale County",5674,3193,8965,2481,0.632905744562186,0.356162855549359,0.276742889012828
"Tennessee",47099,"Lawrence County",15334,3195,18718,12139,0.819211454215194,0.170691313174484,0.648520141040709
"Tennessee",47101,"Lewis County",4474,1072,5609,3402,0.797646639329649,0.191121412016402,0.606525227313247
"Tennessee",47103,"Lincoln County",12281,2919,15608,9362,0.786840082009226,0.187019477191184,0.599820604818042
"Tennessee",47105,"Loudon County",21713,6948,29347,14765,0.739871196374416,0.236753330834498,0.503117865539919
"Tennessee",47107,"McMinn County",18198,4361,22844,13837,0.796620556820172,0.190903519523726,0.605717037296446
"Tennessee",47109,"McNairy County",9093,1943,11275,7150,0.806474501108647,0.172328159645233,0.634146341463415
"Tennessee",47111,"Macon County",8096,1307,9487,6789,0.853378307157162,0.137767471276484,0.715610835880679
"Tennessee",47113,"Madison County",23943,18390,42950,5553,0.557462165308498,0.428172293364377,0.129289871944121
"Tennessee",47115,"Marion County",9911,3177,13256,6734,0.747661436330718,0.239665057332529,0.50799637899819
"Tennessee",47117,"Marshall County",11043,3605,14878,7438,0.742236859792983,0.242304073128109,0.499932786664874
"Tennessee",47119,"Maury County",31464,14418,46657,17046,0.674368261997128,0.309021154381979,0.365347107615149
"Tennessee",47121,"Meigs County",4467,1008,5532,3459,0.807483731019523,0.182212581344902,0.62527114967462
"Tennessee",47123,"Monroe County",16783,3764,20797,13019,0.806991392989374,0.18098764244843,0.626003750540943
"Tennessee",47125,"Montgomery County",42187,32472,76758,9715,0.549610464055864,0.423043852106621,0.126566611949243
"Tennessee",47127,"Moore County",2888,573,3539,2315,0.816049731562588,0.161910144108505,0.654139587454083
"Tennessee",47129,"Morgan County",6930,1167,8228,5763,0.842245989304813,0.141832766164317,0.700413223140496
"Tennessee",47131,"Obion County",10790,2589,13521,8201,0.798017898084461,0.191479920124251,0.60653797796021
"Tennessee",47133,"Overton County",7918,2033,10037,5885,0.788881139782804,0.202550562917206,0.586330576865597
"Tennessee",47135,"Perry County",2775,615,3428,2160,0.80950991831972,0.179404900816803,0.630105017502917
"Tennessee",47137,"Pickett County",2381,525,2931,1856,0.812350733538042,0.179119754350051,0.63323097918799
"Tennessee",47139,"Polk County",6792,1492,8360,5300,0.81244019138756,0.178468899521531,0.633971291866029
"Tennessee",47141,"Putnam County",23759,9185,33593,14574,0.707260441163338,0.273420057750127,0.433840383413211
"Tennessee",47143,"Rhea County",11050,2369,13637,8681,0.810295519542421,0.173718559800543,0.636576959741879
"Tennessee",47145,"Roane County",19230,6043,25917,13187,0.741984025928927,0.233167419068565,0.508816606860362
"Tennessee",47147,"Robertson County",24536,8692,33717,15844,0.727704125515319,0.257792804816561,0.469911320698757
"Tennessee",47149,"Rutherford County",81480,59341,143878,22139,0.566313126398755,0.412439705861911,0.153873420536844
"Tennessee",47151,"Scott County",8004,986,9052,7018,0.884224480777729,0.108926204153778,0.77529827662395
"Tennessee",47153,"Sequatchie County",5855,1298,7252,4557,0.807363485934914,0.178985107556536,0.628378378378378
"Tennessee",47155,"Sevier County",33783,8721,43535,25062,0.775996324796141,0.200321580337659,0.575674744458482
"Tennessee",47157,"Shelby County",129815,246105,382055,-116290,0.339780921595058,0.644161180981796,-0.304380259386738
"Tennessee",47159,"Smith County",7136,1802,9051,5334,0.78842116893161,0.199094022759916,0.589327146171694
"Tennessee",47161,"Stewart County",4950,1232,6296,3718,0.786213468869123,0.195679796696315,0.590533672172808
"Tennessee",47163,"Sullivan County",55860,17272,74357,38588,0.751240636389311,0.232284788251274,0.518955848138037
"Tennessee",47165,"Sumner County",63454,27680,92630,35774,0.685026449314477,0.29882327539674,0.386203173917737
"Tennessee",47167,"Tipton County",20070,6837,27308,13233,0.734949465358137,0.25036619305698,0.484583272301157
"Tennessee",47169,"Trousdale County",2936,1012,3998,1924,0.734367183591796,0.253126563281641,0.481240620310155
"Tennessee",47171,"Unicoi County",6599,1615,8307,4984,0.794390273263513,0.194414349343927,0.599975923919586
"Tennessee",47173,"Union County",6803,1249,8123,5554,0.83749846115967,0.153760925766342,0.683737535393328
"Tennessee",47175,"Van Buren County",2342,544,2921,1798,0.801780212256077,0.186237589866484,0.615542622389593
"Tennessee",47177,"Warren County",11850,3924,16009,7926,0.740208632644138,0.245112124430008,0.49509650821413
"Tennessee",47179,"Washington County",40444,18638,60203,21806,0.671793764430344,0.309585901034832,0.362207863395512
"Tennessee",47181,"Wayne County",5795,820,6669,4975,0.868945868945869,0.122956965062228,0.745988903883641
"Tennessee",47183,"Weakley County",10396,3020,13735,7376,0.756898434655988,0.219876228613032,0.537022206042956
"Tennessee",47185,"White County",9606,2143,11895,7463,0.807566204287516,0.180159730979403,0.627406473308113
"Tennessee",47187,"Williamson County",86469,50161,139016,36308,0.622007538700581,0.360828969327272,0.26117856937331
"Tennessee",47189,"Wilson County",50296,22254,74330,28042,0.676658146105206,0.299394591685726,0.377263554419481
"Texas",48001,"Anderson County",15110,3955,19227,11155,0.785874031310137,0.205700317262183,0.580173714047953
"Texas",48003,"Andrews County",4943,850,5863,4093,0.84308374552277,0.144976974245267,0.698106771277503
"Texas",48005,"Angelina County",25076,9143,34574,15933,0.725284896164748,0.26444727251692,0.460837623647828
"Texas",48007,"Aransas County",9239,2916,12290,6323,0.751749389747762,0.23726606997559,0.514483319772173
"Texas",48009,"Archer County",4300,446,4796,3854,0.896580483736447,0.0929941618015012,0.803586321934946
"Texas",48011,"Armstrong County",1035,75,1112,960,0.930755395683453,0.0674460431654676,0.863309352517986
"Texas",48013,"Atascosa County",12039,5876,18118,6163,0.664477315376973,0.324318357434595,0.340158957942378
"Texas",48015,"Austin County",11447,2951,14554,8496,0.786519169987632,0.20276212725024,0.583757042737392
"Texas",48017,"Bailey County",1434,409,1860,1025,0.770967741935484,0.21989247311828,0.551075268817204
"Texas",48019,"Bandera County",10057,2505,12715,7552,0.790955564294141,0.197011403853716,0.593944160440425
"Texas",48021,"Bastrop County",20516,15474,36665,5042,0.559552706941225,0.422037365334788,0.137515341606437
"Texas",48023,"Baylor County",1494,183,1702,1311,0.877790834312573,0.107520564042303,0.77027027027027
"Texas",48025,"Bee County",6006,3288,9420,2718,0.637579617834395,0.349044585987261,0.288535031847134
"Texas",48027,"Bell County",67893,57014,127375,10879,0.533016683022571,0.447607458292444,0.0854092247301275
"Texas",48029,"Bexar County",308618,448452,768952,-139834,0.401348848822813,0.583198951299951,-0.181850102477138
"Texas",48031,"Blanco County",5443,1911,7441,3532,0.73148770326569,0.256820319849483,0.474667383416208
"Texas",48033,"Borden County",397,16,416,381,0.954326923076923,0.0384615384615385,0.915865384615385
"Texas",48035,"Bosque County",7469,1561,9126,5908,0.818430856892395,0.171049747972825,0.64738110891957
"Texas",48037,"Bowie County",27116,10747,38261,16369,0.708711220302658,0.280886542432242,0.427824677870416
"Texas",48039,"Brazoria County",90433,62228,154984,28205,0.583498941826253,0.40151241418469,0.181986527641563
"Texas",48041,"Brazos County",47530,35349,85061,12181,0.558775467017787,0.415572353957748,0.143203113060039
"Texas",48043,"Brewster County",2461,2258,4822,203,0.510369141435089,0.468270427208627,0.042098714226462
"Texas",48045,"Briscoe County",639,78,725,561,0.881379310344828,0.107586206896552,0.773793103448276
"Texas",48047,"Brooks County",998,1470,2484,-472,0.401771336553945,0.591787439613527,-0.190016103059581
"Texas",48049,"Brown County",13698,2107,15969,11591,0.857786962239339,0.131943139833427,0.725843822405911
"Texas",48051,"Burleson County",6743,1788,8609,4955,0.783250087118132,0.207689627134394,0.575560459983738
"Texas",48053,"Burnet County",18767,5639,24717,13128,0.759274992919853,0.228142573936966,0.531132418982886
"Texas",48055,"Caldwell County",8031,6672,14973,1359,0.536365457824083,0.445602083750751,0.0907633740733321
"Texas",48057,"Calhoun County",5641,2148,7856,3493,0.718049898167006,0.273421588594705,0.444628309572301
"Texas",48059,"Callahan County",6012,734,6832,5278,0.879976580796253,0.107435597189696,0.772540983606557
"Texas",48061,"Cameron County",49032,64063,114174,-15031,0.429449787166956,0.561099724981169,-0.131649937814213
"Texas",48063,"Camp County",3626,1394,5060,2232,0.716600790513834,0.275494071146245,0.441106719367589
"Texas",48065,"Carson County",2779,297,3122,2482,0.890134529147982,0.0951313260730301,0.795003203074952
"Texas",48067,"Cass County",11033,2795,13927,8238,0.792202197170963,0.200689308537373,0.591512888633589
"Texas",48069,"Castro County",1602,466,2083,1136,0.769083053288526,0.223715794527124,0.545367258761402
"Texas",48071,"Chambers County",17353,3997,21652,13356,0.801450212451506,0.184601884352485,0.616848328099021
"Texas",48073,"Cherokee County",15101,4210,19508,10891,0.774092679926184,0.215808898913266,0.558283781012918
"Texas",48075,"Childress County",1943,310,2279,1633,0.852566915313734,0.136024572180781,0.716542343132953
"Texas",48077,"Clay County",5069,614,5741,4455,0.882947221738373,0.106950008709284,0.775997213029089
"Texas",48079,"Cochran County",809,177,1000,632,0.809,0.177,0.632
"Texas",48081,"Coke County",1586,178,1779,1408,0.891512085441259,0.100056211354694,0.791455874086565
"Texas",48083,"Coleman County",3641,451,4124,3190,0.882880698351115,0.109359844810863,0.773520853540252
"Texas",48085,"Collin County",252318,230945,492216,21373,0.512616412306792,0.469194418710485,0.0434219935963073
"Texas",48087,"Collingsworth County",1048,155,1218,893,0.860426929392447,0.127257799671593,0.733169129720854
"Texas",48089,"Colorado County",7472,2420,9975,5052,0.749072681704261,0.242606516290727,0.506466165413534
"Texas",48091,"Comal County",62740,24826,88863,37914,0.706030631421401,0.27937386763895,0.426656763782452
"Texas",48093,"Comanche County",5177,853,6086,4324,0.850640814985212,0.140157739073283,0.710483075911929
"Texas",48095,"Concho County",1058,197,1268,861,0.834384858044164,0.155362776025237,0.679022082018927
"Texas",48097,"Cooke County",15596,3210,18988,12386,0.821360859490204,0.169054139456499,0.652306720033705
"Texas",48099,"Coryell County",15438,7565,23490,7873,0.657215836526181,0.322051936994466,0.335163899531716
"Texas",48101,"Cottle County",540,113,662,427,0.81570996978852,0.170694864048338,0.645015105740181
"Texas",48103,"Crane County",1247,241,1503,1006,0.829673985362608,0.160345974717232,0.669328010645376
"Texas",48105,"Crockett County",1220,344,1574,876,0.775095298602287,0.218551461245235,0.556543837357052
"Texas",48107,"Crosby County",1396,527,1953,869,0.714797747055812,0.26984126984127,0.444956477214542
"Texas",48109,"Culberson County",415,438,864,-23,0.480324074074074,0.506944444444444,-0.0266203703703703
"Texas",48111,"Dallam County",1389,197,1609,1192,0.863269111249223,0.122436295835923,0.7408328154133
"Texas",48113,"Dallas County",307076,598576,921638,-291500,0.333185046623512,0.649469748426172,-0.31628470180266
"Texas",48115,"Dawson County",2951,808,3789,2143,0.778833465294273,0.213248878332014,0.565584586962259
"Texas",48117,"Deaf Smith County",3294,1264,4610,2030,0.714533622559653,0.274186550976139,0.440347071583514
"Texas",48119,"Delta County",2162,403,2592,1759,0.834104938271605,0.155478395061728,0.678626543209877
"Texas",48121,"Denton County",222480,188695,417964,33785,0.532294647385899,0.451462326898967,0.0808323204869319
"Texas",48123,"DeWitt County",6567,1494,8118,5073,0.808943089430894,0.184035476718404,0.624907612712491
"Texas",48125,"Dickens County",853,130,988,723,0.86336032388664,0.131578947368421,0.731781376518219
"Texas",48127,"Dimmit County",1384,2264,3666,-880,0.377523186033824,0.617566830332788,-0.240043644298963
"Texas",48129,"Donley County",1438,198,1648,1240,0.872572815533981,0.120145631067961,0.752427184466019
"Texas",48131,"Duval County",2443,2575,5053,-132,0.483475163269345,0.509598258460321,-0.0261230951909757
"Texas",48133,"Eastland County",7237,983,8292,6254,0.872768933912205,0.118547998070429,0.754220935841775
"Texas",48135,"Ector County",32697,11367,44581,21330,0.733429039276822,0.254974092102017,0.478454947174806
"Texas",48137,"Edwards County",893,168,1066,725,0.837711069418386,0.157598499061914,0.680112570356473
"Texas",48139,"Ellis County",56717,27565,85493,29152,0.66341103950031,0.322424058110021,0.340986981390289
"Texas",48141,"El Paso County",84331,178126,267215,-93795,0.315592313305765,0.66660180004865,-0.351009486742885
"Texas",48143,"Erath County",13684,2916,16853,10768,0.811962261911826,0.173025574081766,0.63893668783006
"Texas",48145,"Falls County",4177,1899,6133,2278,0.681069623349095,0.309636393282244,0.371433230066851
"Texas",48147,"Fannin County",12171,2655,15004,9516,0.81118368435084,0.176952812583311,0.634230871767529
"Texas",48149,"Fayette County",10171,2661,12941,7510,0.78595162661309,0.205625531257244,0.580326095355846
"Texas",48151,"Fisher County",1448,352,1826,1096,0.792990142387733,0.192771084337349,0.600219058050383
"Texas",48153,"Floyd County",1584,438,2039,1146,0.776851397743992,0.214811181951937,0.562040215792055
"Texas",48155,"Foard County",445,99,551,346,0.807622504537205,0.17967332123412,0.627949183303085
"Texas",48157,"Fort Bend County",157718,195552,357514,-37834,0.44115195488848,0.546977181313179,-0.105825226424699
"Texas",48159,"Franklin County",4161,804,5009,3357,0.83070473148333,0.160511080055899,0.670193651427431
"Texas",48161,"Freestone County",6991,1635,8711,5356,0.802548501894157,0.187693720583171,0.614854781310986
"Texas",48163,"Frio County",2823,2422,5279,401,0.53476037128244,0.458799014964956,0.0759613563174843
"Texas",48165,"Gaines County",5355,576,5995,4779,0.89324437030859,0.0960800667222686,0.797164303586322
"Texas",48167,"Galveston County",93911,58842,155060,35069,0.605642976912163,0.37947891138914,0.226164065523023
"Texas",48169,"Garza County",1413,231,1653,1182,0.85480943738657,0.139745916515427,0.715063520871143
"Texas",48171,"Gillespie County",12514,3176,15846,9338,0.789726113845766,0.200429130379907,0.589296983465859
"Texas",48173,"Glasscock County",611,39,653,572,0.935681470137825,0.0597243491577335,0.875957120980092
"Texas",48175,"Goliad County",3085,877,3988,2208,0.773570712136409,0.219909729187563,0.553660982948847
"Texas",48177,"Gonzales County",5627,1948,7647,3679,0.735844121877861,0.254740421080162,0.481103700797698
"Texas",48179,"Gray County",6840,829,7782,6011,0.878951426368543,0.106527884862503,0.77242354150604
"Texas",48181,"Grayson County",44163,14506,59439,29657,0.74299702215717,0.244048520331769,0.498948501825401
"Texas",48183,"Gregg County",32493,14796,47982,17697,0.677191446792547,0.308365637113918,0.368825809678629
"Texas",48185,"Grimes County",9432,2833,12413,6599,0.75984854587932,0.22822847015226,0.53162007572706
"Texas",48187,"Guadalupe County",47553,28805,77592,18748,0.612859573151871,0.371236725435612,0.241622847716259
"Texas",48189,"Hale County",7177,2279,9584,4898,0.74885225375626,0.237792153589316,0.511060100166945
"Texas",48191,"Hall County",995,168,1168,827,0.851883561643836,0.143835616438356,0.708047945205479
"Texas",48193,"Hamilton County",3616,641,4349,2975,0.831455507013106,0.147390204644746,0.68406530236836
"Texas",48195,"Hansford County",1849,166,2047,1683,0.903273082559844,0.0810942843185149,0.822178798241329
"Texas",48197,"Hardeman County",1330,241,1580,1089,0.841772151898734,0.15253164556962,0.689240506329114
"Texas",48199,"Hardin County",23858,3474,27635,20384,0.863325493034196,0.125710150171883,0.737615342862312
"Texas",48201,"Harris County",700630,918193,1640818,-217563,0.42700043514881,0.55959466558753,-0.13259423043872
"Texas",48203,"Harrison County",21466,7908,29710,13558,0.722517670817906,0.266173005721979,0.456344665095927
"Texas",48205,"Hartley County",1868,195,2078,1673,0.898941289701636,0.0938402309913378,0.805101058710298
"Texas",48207,"Haskell County",1840,353,2214,1487,0.831074977416441,0.159439927732611,0.67163504968383
"Texas",48209,"Hays County",47680,59524,109357,-11844,0.436003182237991,0.544309006282177,-0.108305824044186
"Texas",48211,"Hemphill County",1486,206,1720,1280,0.863953488372093,0.119767441860465,0.744186046511628
"Texas",48213,"Henderson County",28911,7060,36310,21851,0.796226934728725,0.194436794271551,0.601790140457174
"Texas",48215,"Hidalgo County",90527,128199,220884,-37672,0.409839553792941,0.580390612267072,-0.170551058474131
"Texas",48217,"Hill County",11926,2860,14931,9066,0.798740874690242,0.191547786484495,0.607193088205746
"Texas",48219,"Hockley County",6536,1482,8095,5054,0.807411982705374,0.18307597282273,0.624336009882644
"Texas",48221,"Hood County",26496,5648,32541,20848,0.814234350511662,0.17356565563443,0.640668694877232
"Texas",48223,"Hopkins County",12719,3046,15939,9673,0.797979797979798,0.19110358240793,0.606876215571868
"Texas",48225,"Houston County",7060,2314,9437,4746,0.748119105647981,0.24520504397584,0.502914061672142
"Texas",48227,"Howard County",8054,2069,10240,5985,0.7865234375,0.20205078125,0.58447265625
"Texas",48229,"Hudspeth County",779,371,1165,408,0.668669527896996,0.318454935622318,0.350214592274678
"Texas",48231,"Hunt County",29163,8906,38574,20257,0.756027375952714,0.230880904236014,0.5251464717167
"Texas",48233,"Hutchinson County",7681,965,8771,6716,0.875726827043667,0.110021662296203,0.765705164747463
"Texas",48235,"Irion County",759,120,889,639,0.853768278965129,0.134983127109111,0.718785151856018
"Texas",48237,"Jack County",3418,331,3782,3087,0.903754627181386,0.0875198307773665,0.816234796404019
"Texas",48239,"Jackson County",5231,1033,6340,4198,0.825078864353312,0.162933753943218,0.662145110410095
"Texas",48241,"Jasper County",12542,2954,15608,9588,0.803562275756023,0.189261916965659,0.614300358790364
"Texas",48243,"Jeff Davis County",784,501,1305,283,0.600766283524904,0.383908045977012,0.216858237547893
"Texas",48245,"Jefferson County",47570,46073,94739,1497,0.502116340683351,0.486315033935338,0.0158013067480129
"Texas",48247,"Jim Hogg County",833,1197,2036,-364,0.409135559921415,0.587917485265226,-0.178781925343811
"Texas",48249,"Jim Wells County",7453,6119,13669,1334,0.545248372229132,0.447655278367108,0.0975930938620235
"Texas",48251,"Johnson County",54628,16464,72005,38164,0.75866953683772,0.228650788139713,0.530018748698007
"Texas",48253,"Jones County",5660,999,6741,4661,0.839638035899718,0.148197596795728,0.69144043910399
"Texas",48255,"Karnes County",3968,1234,5249,2734,0.75595351495523,0.235092398552105,0.520861116403124
"Texas",48257,"Kaufman County",37624,18405,56703,19219,0.663527502953988,0.324586000740702,0.338941502213287
"Texas",48259,"Kendall County",20083,6020,26438,14063,0.759626295483773,0.227702549360769,0.531923746123005
"Texas",48261,"Kenedy County",127,65,194,62,0.654639175257732,0.335051546391752,0.319587628865979
"Texas",48263,"Kent County",411,47,462,364,0.88961038961039,0.101731601731602,0.787878787878788
"Texas",48265,"Kerr County",20879,6524,27745,14355,0.75253198774554,0.235141466930979,0.517390520814561
"Texas",48267,"Kimble County",1987,284,2292,1703,0.866928446771379,0.1239092495637,0.743019197207679
"Texas",48269,"King County",151,8,159,143,0.949685534591195,0.050314465408805,0.89937106918239
"Texas",48271,"Kinney County",1144,446,1603,698,0.713661883967561,0.278228321896444,0.435433562071117
"Texas",48273,"Kleberg County",5504,5314,10944,190,0.502923976608187,0.485562865497076,0.0173611111111111
"Texas",48275,"Knox County",1180,265,1456,915,0.81043956043956,0.182005494505494,0.628434065934066
"Texas",48277,"Lamar County",16760,4458,21418,12302,0.782519376225605,0.20814268372397,0.574376692501634
"Texas",48279,"Lamb County",3521,840,4408,2681,0.798774954627949,0.190562613430127,0.608212341197822
"Texas",48281,"Lampasas County",8086,2144,10399,5942,0.7775747668045,0.206173670545245,0.571401096259256
"Texas",48283,"La Salle County",1335,1052,2406,283,0.554862842892768,0.437240232751455,0.117622610141313
"Texas",48285,"Lavaca County",8804,1333,10197,7471,0.863391193488281,0.130724722957733,0.732666470530548
"Texas",48287,"Lee County",6255,1750,8086,4505,0.773559238189463,0.216423447934702,0.557135790254761
"Texas",48289,"Leon County",7523,1072,8674,6451,0.867304588425179,0.123587733456306,0.743716854968872
"Texas",48291,"Liberty County",23302,5785,29334,17517,0.794368309811141,0.197211427013022,0.597156882798118
"Texas",48293,"Limestone County",6789,2213,9095,4576,0.746454095656954,0.243320505772402,0.503133589884552
"Texas",48295,"Lipscomb County",1205,131,1353,1074,0.890613451589061,0.0968218773096822,0.793791574279379
"Texas",48297,"Live Oak County",4199,819,5054,3380,0.830827067669173,0.162049861495845,0.668777206173328
"Texas",48299,"Llano County",10079,2465,12660,7614,0.796129541864139,0.194707740916272,0.601421800947867
"Texas",48301,"Loving County",60,4,66,56,0.909090909090909,0.0606060606060606,0.848484848484848
"Texas",48303,"Lubbock County",78861,40017,120771,38844,0.652979606031249,0.331346101299153,0.321633504732096
"Texas",48305,"Lynn County",1853,428,2293,1425,0.808111644134322,0.186655037069341,0.62145660706498
"Texas",48307,"McCulloch County",2904,490,3436,2414,0.845168800931316,0.142607683352736,0.70256111757858
"Texas",48309,"McLennan County",59543,36688,97771,22855,0.60900471509957,0.375244193063383,0.233760522036187
"Texas",48311,"McMullen County",460,53,516,407,0.891472868217054,0.102713178294574,0.788759689922481
"Texas",48313,"Madison County",4169,1088,5297,3081,0.787049273173494,0.2053992826128,0.581649990560695
"Texas",48315,"Marion County",3470,1339,4864,2131,0.713404605263158,0.275287828947368,0.438116776315789
"Texas",48317,"Martin County",1857,288,2160,1569,0.859722222222222,0.133333333333333,0.726388888888889
"Texas",48319,"Mason County",1991,457,2474,1534,0.804769603880356,0.184721099434115,0.620048504446241
"Texas",48321,"Matagorda County",9845,3733,13726,6112,0.717251930642576,0.271965612705814,0.445286317936762
"Texas",48323,"Maverick County",6881,8332,15346,-1451,0.448390460054737,0.542942786393849,-0.0945523263391112
"Texas",48325,"Medina County",15642,6773,22644,8869,0.690779014308426,0.299107931460873,0.391671082847553
"Texas",48327,"Menard County",823,197,1028,626,0.800583657587549,0.191634241245136,0.608949416342413
"Texas",48329,"Midland County",45624,12329,58856,33295,0.775180100584477,0.209477368492592,0.565702732091885
"Texas",48331,"Milam County",7984,2496,10576,5488,0.754916792738275,0.236006051437216,0.518910741301059
"Texas",48333,"Mills County",2217,271,2505,1946,0.88502994011976,0.108183632734531,0.77684630738523
"Texas",48335,"Mitchell County",2170,397,2579,1773,0.841411399767352,0.153935633966654,0.687475765800698
"Texas",48337,"Montague County",8615,1097,9814,7518,0.877827593234155,0.111779091094355,0.7660485021398
"Texas",48339,"Montgomery County",193382,74377,271451,119005,0.712401133169522,0.273997885437888,0.438403247731635
"Texas",48341,"Moore County",4359,1062,5508,3297,0.791394335511983,0.19281045751634,0.598583877995643
"Texas",48343,"Morris County",3872,1669,5587,2203,0.693037408269196,0.298729192768928,0.394308215500269
"Texas",48345,"Motley County",604,46,652,558,0.92638036809816,0.0705521472392638,0.855828220858896
"Texas",48347,"Nacogdoches County",17378,9000,26763,8378,0.649329297911295,0.336285169824011,0.313044128087285
"Texas",48349,"Navarro County",13800,5101,19121,8699,0.721719575336018,0.266774750274567,0.454944825061451
"Texas",48351,"Newton County",4882,1173,6094,3709,0.801115851657368,0.192484410895963,0.608631440761405
"Texas",48353,"Nolan County",4131,1162,5356,2969,0.771284540702016,0.216952949962659,0.554331590739358
"Texas",48355,"Nueces County",64617,60925,127314,3692,0.507540411895,0.478541244482147,0.0289991674128532
"Texas",48357,"Ochiltree County",2812,302,3156,2510,0.891001267427123,0.0956907477820025,0.79531051964512
"Texas",48359,"Oldham County",917,81,1009,836,0.908820614469772,0.0802775024777007,0.828543111992071
"Texas",48361,"Orange County",29186,6357,35994,22829,0.810857365116408,0.176612768794799,0.634244596321609
"Texas",48363,"Palo Pinto County",10179,2178,12485,8001,0.815298358029636,0.174449339207048,0.640849018822587
"Texas",48365,"Panola County",9326,2057,11451,7269,0.814426687625535,0.179634966378482,0.634791721247053
"Texas",48367,"Parker County",62045,13017,76128,49028,0.815008932324506,0.170988335435057,0.644020596889449
"Texas",48369,"Parmer County",2135,488,2650,1647,0.805660377358491,0.184150943396226,0.621509433962264
"Texas",48371,"Pecos County",3215,1382,4668,1833,0.688731790916881,0.296058269065981,0.3926735218509
"Texas",48373,"Polk County",18573,5387,24181,13186,0.7680823787271,0.222778214300484,0.545304164426616
"Texas",48375,"Potter County",22820,9921,33321,12899,0.68485339575643,0.297740163860628,0.387113231895801
"Texas",48377,"Presidio County",721,1463,2217,-742,0.325214253495715,0.659900766801985,-0.33468651330627
"Texas",48379,"Rains County",5155,842,6053,4313,0.851643812985297,0.139104576243185,0.712539236742111
"Texas",48381,"Randall County",50796,12802,64674,37994,0.785416086835513,0.19794662460958,0.587469462225933
"Texas",48383,"Reagan County",942,172,1124,770,0.838078291814947,0.153024911032028,0.685053380782918
"Texas",48385,"Real County",1643,320,1982,1323,0.828960645812311,0.161453077699294,0.667507568113017
"Texas",48387,"Red River County",4517,1246,5806,3271,0.777988287977954,0.214605580434034,0.56338270754392
"Texas",48389,"Reeves County",2254,1395,3687,859,0.611337130458367,0.378356387306754,0.232980743151614
"Texas",48391,"Refugio County",2210,1108,3366,1102,0.656565656565657,0.329174093879976,0.32739156268568
"Texas",48393,"Roberts County",529,17,550,512,0.961818181818182,0.0309090909090909,0.930909090909091
"Texas",48395,"Robertson County",5646,2374,8099,3272,0.697123101617484,0.293122607729349,0.404000493888134
"Texas",48397,"Rockwall County",36726,16412,53891,20314,0.68148670464456,0.304540646861257,0.376946057783303
"Texas",48399,"Runnels County",3807,552,4409,3255,0.863461102290769,0.125198457700159,0.73826264459061
"Texas",48401,"Rusk County",16534,4629,21368,11905,0.773773867465369,0.216632347435417,0.557141520029951
"Texas",48403,"Sabine County",4784,669,5487,4115,0.871878986695827,0.121924548933844,0.749954437761983
"Texas",48405,"San Augustine County",3007,980,4002,2027,0.751374312843578,0.24487756121939,0.506496751624188
"Texas",48407,"San Jacinto County",10161,2337,12638,7824,0.804003798069315,0.184918499762621,0.619085298306694
"Texas",48409,"San Patricio County",16516,8988,25888,7528,0.637978986402967,0.347187886279357,0.290791100123609
"Texas",48411,"San Saba County",2308,287,2602,2021,0.887009992313605,0.110299769408148,0.776710222905457
"Texas",48413,"Schleicher County",940,211,1159,729,0.811044003451251,0.182053494391717,0.628990509059534
"Texas",48415,"Scurry County",4983,818,5869,4165,0.849037314704379,0.139376384392571,0.709660930311808
"Texas",48417,"Shackelford County",1484,130,1628,1354,0.911547911547912,0.0798525798525798,0.831695331695332
"Texas",48419,"Shelby County",7975,2068,10084,5907,0.79085680285601,0.205077350257834,0.585779452598175
"Texas",48421,"Sherman County",886,91,991,795,0.894046417759839,0.0918264379414733,0.802219979818365
"Texas",48423,"Smith County",69080,29615,100075,39465,0.690282288283787,0.29592805395953,0.394354234324257
"Texas",48425,"Somervell County",4105,768,4947,3337,0.829795835860117,0.155245603395998,0.67455023246412
"Texas",48427,"Starr County",8247,9123,17525,-876,0.47058487874465,0.520570613409415,-0.0499857346647646
"Texas",48429,"Stephens County",3385,397,3800,2988,0.890789473684211,0.104473684210526,0.786315789473684
"Texas",48431,"Sterling County",584,51,639,533,0.913928012519562,0.07981220657277,0.834115805946792
"Texas",48433,"Stonewall County",615,116,736,499,0.835597826086957,0.157608695652174,0.677989130434783
"Texas",48435,"Sutton County",1222,322,1557,900,0.784842646114322,0.206807964033398,0.578034682080925
"Texas",48437,"Swisher County",1845,478,2355,1367,0.78343949044586,0.202972399150743,0.580467091295117
"Texas",48439,"Tarrant County",409741,411567,834697,-1826,0.490885914289856,0.493073534468196,-0.00218762017834018
"Texas",48441,"Taylor County",39547,14588,55112,24959,0.717575119756133,0.264697343591232,0.452877776164901
"Texas",48443,"Terrell County",334,119,458,215,0.729257641921397,0.259825327510917,0.46943231441048
"Texas",48445,"Terry County",2812,757,3612,2055,0.778516057585825,0.209579180509413,0.568936877076412
"Texas",48447,"Throckmorton County",806,82,899,724,0.896551724137931,0.0912124582869855,0.805339265850946
"Texas",48449,"Titus County",7570,2856,10539,4714,0.718284467217004,0.270993452889268,0.447291014327735
"Texas",48451,"Tom Green County",32313,12239,45210,20074,0.714731254147313,0.270714443707144,0.444016810440168
"Texas",48453,"Travis County",161337,435860,610349,-274523,0.264335650586795,0.714116022144707,-0.449780371557912
"Texas",48455,"Trinity County",5579,1323,6938,4256,0.804122225425195,0.190688959354281,0.613433266070914
"Texas",48457,"Tyler County",8194,1403,9660,6791,0.84824016563147,0.145238095238095,0.703002070393375
"Texas",48459,"Upshur County",15809,2877,18887,12932,0.837030761899719,0.152326997405623,0.684703764494096
"Texas",48461,"Upton County",1178,170,1368,1008,0.861111111111111,0.124269005847953,0.736842105263158
"Texas",48463,"Uvalde County",6174,4073,10342,2101,0.596983175401276,0.393830980467995,0.203152194933282
"Texas",48465,"Val Verde County",8284,6771,15272,1513,0.542430591932949,0.443360398114196,0.0990701938187533
"Texas",48467,"Van Zandt County",22270,3516,25994,18754,0.856736169885358,0.135261983534662,0.721474186350696
"Texas",48469,"Victoria County",23358,10380,34188,12978,0.683222183222183,0.303615303615304,0.37960687960688
"Texas",48471,"Walker County",15375,7884,23612,7491,0.651151956632221,0.333898017956971,0.31725393867525
"Texas",48473,"Waller County",14260,8191,22734,6069,0.627254332717516,0.360297351983813,0.266956980733703
"Texas",48475,"Ward County",3241,764,4060,2477,0.798275862068966,0.188177339901478,0.610098522167488
"Texas",48477,"Washington County",12959,4261,17418,8698,0.744000459294982,0.24463198989551,0.499368469399472
"Texas",48479,"Webb County",25898,41820,68397,-15922,0.378642338114245,0.611430325891486,-0.232787987777242
"Texas",48481,"Wharton County",11926,4694,16761,7232,0.711532724777758,0.280054889326412,0.431477835451345
"Texas",48483,"Wheeler County",2159,168,2337,1991,0.923833975181857,0.0718870346598203,0.851946940522037
"Texas",48485,"Wichita County",32069,13161,46030,18908,0.69669780577884,0.285922224636107,0.410775581142733
"Texas",48487,"Wilbarger County",3524,956,4524,2568,0.7789566755084,0.21131741821397,0.56763925729443
"Texas",48489,"Willacy County",2441,3108,5549,-667,0.43989908091548,0.56010091908452,-0.12020183816904
"Texas",48491,"Williamson County",139729,143795,289312,-4066,0.482969942484238,0.497023974117907,-0.0140540316336689
"Texas",48493,"Wilson County",18463,6350,25013,12113,0.73813616919202,0.253867988645904,0.484268180546116
"Texas",48495,"Winkler County",1753,358,2126,1395,0.824553151458137,0.168391345249294,0.656161806208843
"Texas",48497,"Wise County",27032,4973,32362,22059,0.83530066126939,0.153667882083926,0.681632779185464
"Texas",48499,"Wood County",19049,3509,22779,15540,0.836252688880109,0.154045392686246,0.682207296193863
"Texas",48501,"Yoakum County",2174,420,2631,1754,0.826301786393006,0.15963511972634,0.666666666666667
"Texas",48503,"Young County",7110,1034,8239,6076,0.86296880689404,0.125500667556742,0.737468139337298
"Texas",48505,"Zapata County",2033,1826,3874,207,0.524780588538978,0.471347444501807,0.0534331440371709
"Texas",48507,"Zavala County",1490,2864,4379,-1374,0.340260333409454,0.654030600593743,-0.313770267184289
"Utah",49001,"Beaver County",2695,357,3100,2338,0.869354838709677,0.115161290322581,0.754193548387097
"Utah",49003,"Box Elder County",21548,4473,27027,17075,0.797276797276797,0.165501165501166,0.631775631775632
"Utah",49005,"Cache County",38032,16650,57571,21382,0.660610376752184,0.289208108248945,0.37140226850324
"Utah",49007,"Carbon County",6693,2392,9369,4301,0.714377201408902,0.255310065108336,0.459067136300566
"Utah",49009,"Daggett County",496,111,619,385,0.801292407108239,0.179321486268174,0.621970920840065
"Utah",49011,"Davis County",104135,57411,169895,46724,0.612937402513317,0.337920480296654,0.275016922216663
"Utah",49013,"Duchesne County",7513,843,8524,6670,0.88139371187236,0.0988972313467856,0.782496480525575
"Utah",49015,"Emery County",4207,572,4865,3635,0.864748201438849,0.117574511819116,0.747173689619733
"Utah",49017,"Garfield County",2158,514,2732,1644,0.789897510980966,0.18814055636896,0.601756954612006
"Utah",49019,"Grand County",2248,2806,5185,-558,0.433558341369335,0.541176470588235,-0.107618129218901
"Utah",49021,"Iron County",18989,4892,24890,14097,0.762916834069908,0.196544797107272,0.566372036962636
"Utah",49023,"Juab County",5087,645,5866,4442,0.867200818274804,0.109955676781452,0.757245141493352
"Utah",49025,"Kane County",2998,1083,4180,1915,0.717224880382775,0.259090909090909,0.458133971291866
"Utah",49027,"Millard County",5404,624,6160,4780,0.877272727272727,0.101298701298701,0.775974025974026
"Utah",49029,"Morgan County",5181,1086,6512,4095,0.795608108108108,0.166769041769042,0.628839066339066
"Utah",49031,"Piute County",773,86,871,687,0.887485648679678,0.0987370838117107,0.788748564867968
"Utah",49033,"Rich County",1157,180,1363,977,0.848862802641233,0.132061628760088,0.716801173881145
"Utah",49035,"Salt Lake County",230174,289906,541175,-59732,0.425322677507276,0.535697325264471,-0.110374647757195
"Utah",49037,"San Juan County",3535,3113,6878,422,0.513957545798197,0.452602500726956,0.0613550450712417
"Utah",49039,"Sanpete County",10459,1794,12631,8665,0.828042118597102,0.142031509777531,0.686010608819571
"Utah",49041,"Sevier County",9052,1084,10363,7968,0.873492231979157,0.104602914214031,0.768889317765126
"Utah",49043,"Summit County",10252,15244,26088,-4992,0.392977614228764,0.584329960134928,-0.191352345906164
"Utah",49045,"Tooele County",21014,8943,31518,12071,0.6667301224697,0.283742623262897,0.382987499206802
"Utah",49047,"Uintah County",13261,1663,15307,11598,0.866335663421964,0.108643104462011,0.757692558959953
"Utah",49049,"Utah County",192812,76033,284480,116779,0.677769966254218,0.267270106861642,0.410499859392576
"Utah",49051,"Wasatch County",10795,6187,17581,4608,0.614015129969854,0.351913998066094,0.26210113190376
"Utah",49053,"Washington County",67294,20530,90476,46764,0.743777355320748,0.226911004023166,0.516866351297582
"Utah",49055,"Wayne County",1229,365,1621,864,0.75817396668723,0.225169648365207,0.533004318322023
"Utah",49057,"Weber County",65949,40695,111442,25254,0.591778683081782,0.365167531092407,0.226611151989376
"Vermont",50001,"Addison County",6292,14967,22022,-8675,0.285714285714286,0.679638543274907,-0.393924257560621
"Vermont",50003,"Bennington County",7114,12705,20462,-5591,0.347668849574822,0.620907047209461,-0.27323819763464
"Vermont",50005,"Caledonia County",6551,9011,16169,-2460,0.40515801843033,0.557301008101923,-0.152142989671594
"Vermont",50007,"Chittenden County",21017,74961,98915,-53944,0.212475357630289,0.757832482434413,-0.545357124804125
"Vermont",50009,"Essex County",1773,1405,3288,368,0.539233576642336,0.427311435523114,0.111922141119221
"Vermont",50011,"Franklin County",11274,13611,25830,-2337,0.436469221835075,0.526945412311266,-0.0904761904761905
"Vermont",50013,"Grand Isle County",1810,2905,4851,-1095,0.373118944547516,0.598845598845599,-0.225726654298083
"Vermont",50015,"Lamoille County",4163,10240,14915,-6077,0.279114984914516,0.686557157224271,-0.407442172309755
"Vermont",50017,"Orange County",6187,10304,17122,-4117,0.361347973367597,0.601798855273917,-0.240450881906319
"Vermont",50019,"Orleans County",6512,7147,14096,-635,0.461975028376845,0.507023269012486,-0.0450482406356413
"Vermont",50021,"Rutland County",14672,18230,33970,-3558,0.431910509272888,0.53664998528113,-0.104739476008243
"Vermont",50023,"Washington County",8928,25191,35307,-16263,0.2528677032883,0.713484578128983,-0.460616874840683
"Vermont",50025,"Windham County",6440,18767,26035,-12327,0.247359323986941,0.720837334357596,-0.473478010370655
"Vermont",50027,"Windsor County",9971,23376,34446,-13405,0.289467572432213,0.678627416826337,-0.389159844394124
"Virginia",51001,"Accomack County",9172,7578,16962,1594,0.540738120504657,0.446763353378139,0.093974767126518
"Virginia",51003,"Albemarle County",20804,42466,64657,-21662,0.321759438266545,0.65678890143372,-0.335029463167174
"Virginia",51005,"Alleghany County",5859,2243,8203,3616,0.714250883822992,0.273436547604535,0.440814336218457
"Virginia",51007,"Amelia County",5390,2411,7893,2979,0.682883567718231,0.305460534650957,0.377423033067275
"Virginia",51009,"Amherst County",11041,5672,17005,5369,0.649279623640106,0.333548956189356,0.31573066745075
"Virginia",51011,"Appomattox County",6702,2418,9268,4284,0.723133362106172,0.260897712559344,0.462235649546828
"Virginia",51013,"Arlington County",22318,105344,130699,-83026,0.17075876632568,0.806004636607778,-0.635245870282099
"Virginia",51015,"Augusta County",30714,10840,42278,19874,0.726477127584086,0.256398126685274,0.470079000898813
"Virginia",51017,"Bath County",1834,646,2501,1188,0.733306677329068,0.258296681327469,0.475009996001599
"Virginia",51019,"Bedford County",35600,12176,48669,23424,0.731471778750334,0.250179785900676,0.481291992849658
"Virginia",51021,"Bland County",2903,532,3479,2371,0.834435182523714,0.152917505030181,0.681517677493533
"Virginia",51023,"Botetourt County",15099,5700,21120,9399,0.714914772727273,0.269886363636364,0.445028409090909
"Virginia",51025,"Brunswick County",3357,4552,7948,-1195,0.422370407649723,0.572722697533971,-0.150352289884248
"Virginia",51027,"Buchanan County",8311,1587,9953,6724,0.835024615693761,0.159449412237516,0.675575203456244
"Virginia",51029,"Buckingham County",4544,3471,8126,1073,0.559192714742801,0.42714742800886,0.13204528673394
"Virginia",51031,"Campbell County",21245,8070,29892,13175,0.710725277666265,0.269971898835809,0.440753378830456
"Virginia",51033,"Caroline County",8336,7657,16288,679,0.511787819253438,0.47010068762279,0.0416871316306483
"Virginia",51035,"Carroll County",12659,2842,15651,9817,0.808830106702447,0.181585841160309,0.627244265542138
"Virginia",51036,"Charles City County",1761,2624,4441,-863,0.39653231254222,0.590857914884035,-0.194325602341815
"Virginia",51037,"Charlotte County",3815,2317,6191,1498,0.616217089323211,0.374252947827492,0.24196414149572
"Virginia",51041,"Chesterfield County",93326,106935,203884,-13609,0.457740676070707,0.524489415550019,-0.0667487394793117
"Virginia",51043,"Clarke County",5192,3920,9337,1272,0.556067259290993,0.419835064795973,0.13623219449502
"Virginia",51045,"Craig County",2536,587,3169,1949,0.800252445566425,0.185231934364153,0.615020511202272
"Virginia",51047,"Culpeper County",16012,10617,27116,5395,0.590500073757191,0.39154005015489,0.198960023602301
"Virginia",51049,"Cumberland County",3019,2227,5310,792,0.568549905838041,0.41939736346516,0.149152542372881
"Virginia",51051,"Dickenson County",5748,1503,7303,4245,0.787073805285499,0.205805833219225,0.581267972066274
"Virginia",51053,"Dinwiddie County",8695,6224,15092,2471,0.576133050622847,0.412403922608004,0.163729128014842
"Virginia",51057,"Essex County",3075,3038,6178,37,0.497733894464228,0.491744901262544,0.00598899320168339
"Virginia",51059,"Fairfax County",168401,419943,600823,-251542,0.280283877281662,0.698946278687733,-0.418662401406071
"Virginia",51061,"Fauquier County",25106,17565,43661,7541,0.575021185955429,0.402304115801287,0.172717070154142
"Virginia",51063,"Floyd County",6225,3004,9408,3221,0.661670918367347,0.319302721088435,0.342368197278912
"Virginia",51065,"Fluvanna County",8155,7414,15840,741,0.514835858585859,0.468055555555556,0.046780303030303
"Virginia",51067,"Franklin County",20895,8381,29702,12514,0.703487980607367,0.282169550871995,0.421318429735371
"Virginia",51069,"Frederick County",30558,17207,48703,13351,0.62743568158019,0.353304724554956,0.274130957025235
"Virginia",51071,"Giles County",6876,2156,9176,4720,0.749346120313862,0.234960767218832,0.51438535309503
"Virginia",51073,"Gloucester County",14875,6964,22282,7911,0.667579211919935,0.312539269365407,0.355039942554528
"Virginia",51075,"Goochland County",9966,6685,16950,3281,0.587964601769911,0.394395280235988,0.193569321533923
"Virginia",51077,"Grayson County",6529,1535,8131,4994,0.802976263682204,0.188783667445579,0.614192596236625
"Virginia",51079,"Greene County",6866,4163,11311,2703,0.607019715321369,0.368048802051101,0.238970913270268
"Virginia",51081,"Greensville County",1914,2627,4574,-713,0.418452120682116,0.574333187581985,-0.155881066899869
"Virginia",51083,"Halifax County",10418,7666,18248,2752,0.570911880754055,0.420100832967996,0.150811047786059
"Virginia",51085,"Hanover County",44318,25307,70967,19011,0.624487437823214,0.356602364479265,0.267885073343949
"Virginia",51087,"Henrico County",63440,116572,183152,-53132,0.346378963920678,0.636476806150083,-0.290097842229405
"Virginia",51089,"Henry County",16725,9127,26105,7598,0.640681861712316,0.349626508331737,0.291055353380578
"Virginia",51091,"Highland County",1092,417,1533,675,0.712328767123288,0.272015655577299,0.440313111545988
"Virginia",51093,"Isle of Wight County",13707,9399,23456,4308,0.584370736698499,0.400707708049113,0.183663028649386
"Virginia",51095,"James City County",23153,25553,49622,-2400,0.466587400749667,0.514953045020354,-0.0483656442706864
"Virginia",51097,"King and Queen County",2450,1590,4115,860,0.595382746051033,0.386391251518834,0.208991494532199
"Virginia",51099,"King George County",8446,5404,14224,3042,0.593785151856018,0.37992125984252,0.213863892013498
"Virginia",51101,"King William County",7320,3260,10736,4060,0.681818181818182,0.303651266766021,0.378166915052161
"Virginia",51103,"Lancaster County",3697,3368,7152,329,0.516918344519016,0.470917225950783,0.0460011185682326
"Virginia",51105,"Lee County",8365,1489,9946,6876,0.841041624773778,0.149708425497688,0.691333199276091
"Virginia",51107,"Loudoun County",82088,138372,224862,-56284,0.365059458690219,0.615364089975185,-0.250304631284966
"Virginia",51109,"Louisa County",13294,8269,21915,5025,0.606616472735569,0.377321469313256,0.229295003422314
"Virginia",51111,"Lunenburg County",3537,2418,6000,1119,0.5895,0.403,0.1865
"Virginia",51113,"Madison County",5300,2698,8129,2602,0.651986714232993,0.331898142452946,0.320088571780047
"Virginia",51115,"Mathews County",3901,1825,5826,2076,0.66958462066598,0.313250944043941,0.356333676622039
"Virginia",51117,"Mecklenburg County",9266,6803,16204,2463,0.571834115033325,0.419834608738583,0.151999506294742
"Virginia",51119,"Middlesex County",4196,2491,6785,1705,0.618422991893884,0.367133382461312,0.251289609432572
"Virginia",51121,"Montgomery County",20629,23218,45037,-2589,0.4580456069454,0.515531673956969,-0.0574860670115683
"Virginia",51125,"Nelson County",4812,4327,9316,485,0.516530699871189,0.464469729497638,0.0520609703735509
"Virginia",51127,"New Kent County",9631,4621,14463,5010,0.665906105234045,0.319504943649312,0.346401161584733
"Virginia",51131,"Northampton County",2955,3667,6732,-712,0.438948306595365,0.544711824123589,-0.105763517528223
"Virginia",51133,"Northumberland County",4485,3252,7815,1233,0.573896353166987,0.416122840690979,0.157773512476008
"Virginia",51135,"Nottoway County",4027,2971,7078,1056,0.568946029951964,0.419751342187059,0.149194687764905
"Virginia",51137,"Orange County",12426,7995,20742,4431,0.599074341914955,0.385449811975701,0.213624529939254
"Virginia",51139,"Page County",9345,3007,12514,6338,0.746763624740291,0.240290874220873,0.506472750519418
"Virginia",51141,"Patrick County",7485,1954,9534,5531,0.78508495909377,0.20495070274806,0.58013425634571
"Virginia",51143,"Pittsylvania County",23751,10115,34227,13636,0.693925848014725,0.295526923189295,0.39839892482543
"Virginia",51145,"Powhatan County",14055,5320,19730,8735,0.712366953877344,0.269640141915864,0.44272681196148
"Virginia",51147,"Prince Edward County",4434,4973,9574,-539,0.463129308543973,0.519427616461249,-0.056298307917276
"Virginia",51149,"Prince George County",10103,7103,17432,3000,0.579566314823313,0.40746902248738,0.172097292335934
"Virginia",51153,"Prince William County",81222,142863,228056,-61641,0.356149366822184,0.626438243238503,-0.270288876416319
"Virginia",51155,"Pulaski County",12127,4925,17376,7202,0.697916666666667,0.283436924493554,0.414479742173112
"Virginia",51157,"Rappahannock County",2812,2096,4978,716,0.564885496183206,0.421052631578947,0.143832864604259
"Virginia",51159,"Richmond County",2547,1513,4102,1034,0.62091662603608,0.368844466114091,0.252072159921989
"Virginia",51161,"Roanoke County",34268,21801,57184,12467,0.599258533855624,0.381243005036374,0.21801552881925
"Virginia",51163,"Rockbridge County",8088,4086,12373,4002,0.653681403055039,0.33023518952558,0.323446213529459
"Virginia",51165,"Rockingham County",30349,12644,43811,17705,0.692725571203579,0.288603318801214,0.404122252402365
"Virginia",51167,"Russell County",10879,2373,13386,8506,0.812714776632302,0.177274764679516,0.635440011952787
"Virginia",51169,"Scott County",9063,1692,10869,7371,0.833839359646702,0.155672094948937,0.678167264697764
"Virginia",51171,"Shenandoah County",16463,6836,23684,9627,0.69511062320554,0.288633676743793,0.406476946461746
"Virginia",51173,"Smyth County",10963,3008,14136,7955,0.775537634408602,0.212790039615167,0.562747594793435
"Virginia",51175,"Southampton County",5730,3969,9786,1761,0.585530349478847,0.405579399141631,0.179950950337216
"Virginia",51177,"Spotsylvania County",39411,34307,75317,5104,0.523268319237357,0.455501414023395,0.0677669052139623
"Virginia",51179,"Stafford County",37636,40245,79625,-2609,0.472665620094191,0.505431711145997,-0.0327660910518053
"Virginia",51181,"Surry County",2025,2397,4471,-372,0.452918810109595,0.536121673003802,-0.0832028628942071
"Virginia",51183,"Sussex County",2219,2827,5088,-608,0.436124213836478,0.55562106918239,-0.119496855345912
"Virginia",51185,"Tazewell County",16731,3205,20134,13526,0.830982417800735,0.159183470746002,0.671798947054733
"Virginia",51187,"Warren County",14069,6603,21147,7466,0.665295313756088,0.312242871329267,0.353052442426822
"Virginia",51191,"Washington County",21679,6617,28685,15062,0.75576085061879,0.230678054732439,0.525082795886352
"Virginia",51193,"Westmoreland County",5318,4501,9933,817,0.535387093526628,0.453136011275546,0.0822510822510822
"Virginia",51195,"Wise County",13366,3110,16615,10256,0.804453806801083,0.187180258802287,0.617273547998796
"Virginia",51197,"Wythe County",11733,3143,15072,8590,0.778463375796178,0.208532377919321,0.569930997876858
"Virginia",51199,"York County",20241,17683,38787,2558,0.521850104416428,0.455900172738289,0.0659499316781396
"Virginia",51510,"Alexandria city",14544,66240,82508,-51696,0.1762738158724,0.802831240606971,-0.626557424734571
"Virginia",51520,"Bristol city",5347,2313,7806,3034,0.684985908275685,0.296310530361261,0.388675377914425
"Virginia",51530,"Buena Vista city",1863,825,2776,1038,0.671109510086455,0.297190201729107,0.373919308357349
"Virginia",51540,"Charlottesville city",3094,20696,24205,-17602,0.127824829580665,0.855029952489155,-0.72720512290849
"Virginia",51550,"Chesapeake city",58180,66377,127108,-8197,0.457720993171162,0.52220945967209,-0.0644884665009283
"Virginia",51570,"Colonial Heights city",6007,2972,9146,3035,0.656789853487864,0.324950798163131,0.331839055324732
"Virginia",51580,"Covington city",1580,964,2603,616,0.606991932385709,0.370341913177103,0.236650019208605
"Virginia",51590,"Danville city",7428,11710,19389,-4282,0.383103821754603,0.6039506936923,-0.220846871937697
"Virginia",51595,"Emporia city",754,1612,2381,-858,0.316673666526669,0.677026459470811,-0.360352792944141
"Virginia",51600,"Fairfax city",4007,9174,13483,-5167,0.297189052881406,0.680412371134021,-0.383223318252614
"Virginia",51610,"Falls Church city",1490,7146,8819,-5656,0.168953396076653,0.810295951921987,-0.641342555845334
"Virginia",51620,"Franklin city",1487,2525,4058,-1038,0.366436668309512,0.622227698373583,-0.255791030064071
"Virginia",51630,"Fredericksburg city",4037,8517,12862,-4480,0.313870315658529,0.662183175244907,-0.348312859586378
"Virginia",51640,"Galax city",1838,777,2638,1061,0.696739954510993,0.294541319181198,0.402198635329795
"Virginia",51650,"Hampton city",18430,46220,65901,-27790,0.279661917118101,0.701355062897376,-0.421693145779275
"Virginia",51660,"Harrisonburg city",5591,11022,17086,-5431,0.327226969448671,0.645089546997542,-0.31786257754887
"Virginia",51670,"Hopewell city",4020,5430,9608,-1410,0.418401332223147,0.565154038301416,-0.146752706078268
"Virginia",51678,"Lexington city",906,1791,2762,-885,0.328023171614772,0.648443157132513,-0.320419985517741
"Virginia",51680,"Lynchburg city",17097,18048,36363,-951,0.470175728075241,0.496328685752001,-0.0261529576767593
"Virginia",51683,"Manassas city",6256,10356,16968,-4100,0.368694012258369,0.61032531824611,-0.241631305987742
"Virginia",51685,"Manassas Park city",1979,3992,6087,-2013,0.325119106292098,0.655823886972236,-0.330704780680138
"Virginia",51690,"Martinsville city",2165,3766,6013,-1601,0.360053218027607,0.626309662398137,-0.26625644437053
"Virginia",51700,"Newport News city",26377,53099,81203,-26722,0.324827900447028,0.653904412398557,-0.329076511951529
"Virginia",51710,"Norfolk city",23443,64440,89881,-40997,0.260822643272772,0.71694796453088,-0.456125321258108
"Virginia",51720,"Norton city",1109,464,1601,645,0.692692067457839,0.289818863210493,0.402873204247345
"Virginia",51730,"Petersburg city",1584,12389,14118,-10805,0.112197195070123,0.877532228360958,-0.765335033290834
"Virginia",51735,"Poquoson city",5605,2054,7857,3551,0.713376606847397,0.261422934962454,0.451953671884943
"Virginia",51740,"Portsmouth city",12755,30948,44582,-18193,0.286102014265847,0.694181508232022,-0.408079493966175
"Virginia",51750,"Radford city",2786,3358,6320,-572,0.440822784810127,0.531329113924051,-0.090506329113924
"Virginia",51760,"Richmond city",16603,92175,111159,-75572,0.149362624708751,0.829217607211292,-0.679854982502541
"Virginia",51770,"Roanoke city",15607,26773,43323,-11166,0.360247443621171,0.617985827389608,-0.257738383768437
"Virginia",51775,"Salem city",7683,5148,13051,2535,0.588690521799096,0.394452532372998,0.194237989426098
"Virginia",51790,"Staunton city",5695,6981,12990,-1286,0.438414164742109,0.537413394919169,-0.0989992301770593
"Virginia",51800,"Suffolk city",20082,28676,49642,-8594,0.404536481205431,0.577656017082309,-0.173119535876878
"Virginia",51810,"Virginia Beach city",105087,117393,227561,-12306,0.461797056613392,0.515874864322094,-0.0540778077087022
"Virginia",51820,"Waynesboro city",5507,4961,10717,546,0.513856489689279,0.462909396286274,0.0509470934030045
"Virginia",51830,"Williamsburg city",1963,4790,6883,-2827,0.285195408978643,0.695917477843963,-0.41072206886532
"Virginia",51840,"Winchester city",5221,6610,12106,-1389,0.431273748554436,0.546010242854783,-0.114736494300347
"Washington",53001,"Adams County",3907,1814,5862,2093,0.666496076424429,0.309450699419993,0.357045377004435
"Washington",53003,"Asotin County",7319,4250,11951,3069,0.612417370931303,0.355618776671408,0.256798594259895
"Washington",53005,"Benton County",60365,38706,103033,21659,0.58588025195811,0.375666048741665,0.210214203216445
"Washington",53007,"Chelan County",22746,19349,43306,3397,0.52523899690574,0.446797210548192,0.0784417863575486
"Washington",53009,"Clallam County",23062,24721,49264,-1659,0.46813088665151,0.501806593049691,-0.0336757063981812
"Washington",53011,"Clark County",126303,140324,275403,-14021,0.458611561965556,0.509522408978842,-0.050910847013286
"Washington",53013,"Columbia County",1754,668,2495,1086,0.703006012024048,0.267735470941884,0.435270541082164
"Washington",53015,"Cowlitz County",34424,23938,60280,10486,0.571068347710683,0.397113470471135,0.173954877239549
"Washington",53017,"Douglas County",12955,7811,21308,5144,0.607987610287216,0.366575933921532,0.241411676365684
"Washington",53019,"Ferry County",2771,1486,4367,1285,0.634531715136249,0.340279367987177,0.294252347149073
"Washington",53021,"Franklin County",18039,13340,32404,4699,0.556690532033082,0.411677570670288,0.145012961362795
"Washington",53023,"Garfield County",1069,366,1489,703,0.717931497649429,0.245802552048355,0.472128945601074
"Washington",53025,"Grant County",24764,11819,37680,12945,0.657218683651805,0.313667728237792,0.343550955414013
"Washington",53027,"Grays Harbor County",19877,17354,38441,2523,0.517078119715928,0.451445071668271,0.0656330480476575
"Washington",53029,"Island County",22746,29213,53925,-6467,0.421808066759388,0.541733889661567,-0.119925822902179
"Washington",53031,"Jefferson County",6931,17204,24792,-10273,0.279565989028719,0.693933526944176,-0.414367537915457
"Washington",53033,"King County",269167,907310,1210507,-638143,0.222358895900643,0.749528916396188,-0.527170020495544
"Washington",53035,"Kitsap County",61563,90277,158672,-28714,0.387989059191288,0.568953564586064,-0.180964505394777
"Washington",53037,"Kittitas County",14105,11421,26364,2684,0.535009861932939,0.433204369594902,0.101805492338037
"Washington",53039,"Klickitat County",7237,5959,13560,1278,0.533702064896755,0.439454277286136,0.0942477876106195
"Washington",53041,"Lewis County",29391,14520,45309,14871,0.648679070383368,0.320466132556446,0.328212937826922
"Washington",53043,"Lincoln County",5150,1713,7033,3437,0.732262192520973,0.24356604578416,0.488696146736812
"Washington",53045,"Mason County",18710,17269,37303,1441,0.501568238479479,0.462938637643085,0.0386296008363938
"Washington",53047,"Okanogan County",11840,8900,21282,2940,0.556338689972747,0.41819377878019,0.138144911192557
"Washington",53049,"Pacific County",6953,6794,14064,159,0.494382821387941,0.483077360637088,0.0113054607508532
"Washington",53051,"Pend Oreille County",5728,2593,8553,3135,0.669706535718461,0.303168478896294,0.366538056822168
"Washington",53053,"Pierce County",197730,249506,464081,-51776,0.4260678631532,0.537634593960968,-0.111566730807768
"Washington",53055,"San Juan County",3057,9725,13197,-6668,0.231643555353489,0.736909903766007,-0.505266348412518
"Washington",53057,"Skagit County",32762,38252,73423,-5490,0.446208953597647,0.520981163940455,-0.0747722103428081
"Washington",53059,"Skamania County",3885,3192,7312,693,0.531318380743983,0.436542669584245,0.0947757111597374
"Washington",53061,"Snohomish County",166428,256728,438796,-90300,0.379283311607216,0.585073701674582,-0.205790390067366
"Washington",53063,"Spokane County",148576,135765,295430,12811,0.502914395965203,0.459550485732661,0.0433639102325424
"Washington",53065,"Stevens County",19808,7839,28430,11969,0.696728807597608,0.275729862820964,0.420998944776644
"Washington",53067,"Thurston County",65277,96608,168134,-31331,0.388243900698253,0.574589315664886,-0.186345414966634
"Washington",53069,"Wahkiakum County",1741,1165,2981,576,0.584032203958403,0.390808453539081,0.193223750419322
"Washington",53071,"Walla Walla County",16400,13690,31261,2710,0.524615335401938,0.437925850100765,0.086689485301174
"Washington",53073,"Whatcom County",50489,83660,138620,-33171,0.364225941422594,0.603520415524455,-0.239294474101861
"Washington",53075,"Whitman County",9067,11184,21126,-2117,0.429186784057559,0.529395058222096,-0.100208274164537
"Washington",53077,"Yakima County",50555,43179,96193,7376,0.525557992785338,0.448878816545903,0.0766791762394353
"West Virginia",54001,"Barbour County",5116,1457,6677,3659,0.766212370825221,0.218211771753782,0.548000599071439
"West Virginia",54003,"Berkeley County",33279,17186,51535,16093,0.645755311923935,0.333482099543999,0.312273212379936
"West Virginia",54005,"Boone County",6816,2041,9012,4775,0.756324900133156,0.22647581003107,0.529849090102086
"West Virginia",54007,"Braxton County",4120,1457,5664,2663,0.727401129943503,0.257238700564972,0.470162429378531
"West Virginia",54009,"Brooke County",7545,2947,10656,4598,0.708051801801802,0.276557807807808,0.431493993993994
"West Virginia",54011,"Cabell County",21721,14994,37360,6727,0.58139721627409,0.401338329764454,0.180058886509636
"West Virginia",54013,"Calhoun County",2364,568,2971,1796,0.795691686300909,0.191181420397173,0.604510265903736
"West Virginia",54015,"Clay County",2679,641,3365,2038,0.796136701337296,0.190490341753343,0.605646359583952
"West Virginia",54017,"Doddridge County",2619,435,3101,2184,0.844566268945501,0.140277329893583,0.704288939051919
"West Virginia",54019,"Fayette County",11580,5063,16862,6517,0.68675127505634,0.300260941762543,0.386490333293797
"West Virginia",54021,"Gilmer County",2012,599,2662,1413,0.755822689706987,0.225018782870023,0.530803906836965
"West Virginia",54023,"Grant County",4871,607,5509,4264,0.884189508077691,0.110183336358686,0.774006171719005
"West Virginia",54025,"Greenbrier County",10925,4655,15850,6270,0.689274447949527,0.293690851735016,0.395583596214511
"West Virginia",54027,"Hampshire County",8033,1939,10086,6094,0.796450525480865,0.192246678564347,0.604203846916518
"West Virginia",54029,"Hancock County",9806,3790,13800,6016,0.710579710144927,0.27463768115942,0.435942028985507
"West Virginia",54031,"Hardy County",4859,1381,6331,3478,0.767493287000474,0.218132996367083,0.549360290633391
"West Virginia",54033,"Harrison County",20683,9215,30465,11468,0.678910224848186,0.302478253733793,0.376431971114394
"West Virginia",54035,"Jackson County",10093,3207,13508,6886,0.747186852235712,0.237414865265028,0.509771986970684
"West Virginia",54037,"Jefferson County",15033,12127,27703,2906,0.54264881059813,0.43775042414179,0.10489838645634
"West Virginia",54039,"Kanawha County",46398,34344,82244,12054,0.564150576333836,0.417586693254219,0.146563883079617
"West Virginia",54041,"Lewis County",5782,1538,7457,4244,0.77537883867507,0.206249161861338,0.569129676813732
"West Virginia",54043,"Lincoln County",6012,1711,7830,4301,0.767816091954023,0.218518518518519,0.549297573435504
"West Virginia",54045,"Logan County",10534,2333,13026,8201,0.808690311684324,0.179103331797943,0.629586979886381
"West Virginia",54047,"McDowell County",5148,1333,6527,3815,0.788723762831316,0.204228588938256,0.58449517389306
"West Virginia",54049,"Marion County",16300,8901,25794,7399,0.631929906179732,0.345080251221214,0.286849654958518
"West Virginia",54051,"Marshall County",10435,3455,14080,6980,0.741122159090909,0.245383522727273,0.495738636363636
"West Virginia",54053,"Mason County",8491,2526,11203,5965,0.75792198518254,0.225475319110952,0.532446666071588
"West Virginia",54055,"Mercer County",19237,5556,25134,13681,0.765377576191613,0.221055144425877,0.544322431765736
"West Virginia",54057,"Mineral County",10040,2660,12872,7380,0.779987569919204,0.206650093225606,0.573337476693599
"West Virginia",54059,"Mingo County",8544,1397,10022,7147,0.85252444621832,0.13939333466374,0.71313111155458
"West Virginia",54061,"Monongalia County",20803,20282,42072,521,0.494461874881156,0.482078341890093,0.0123835329910629
"West Virginia",54063,"Monroe County",5068,1345,6490,3723,0.780893682588598,0.207241910631741,0.573651771956857
"West Virginia",54065,"Morgan County",6537,1998,8695,4539,0.751811385853939,0.229787234042553,0.522024151811386
"West Virginia",54067,"Nicholas County",8279,2226,10630,6053,0.778833490122295,0.209407337723424,0.569426152398871
"West Virginia",54069,"Ohio County",12354,7223,19898,5131,0.620866418735551,0.363001306663986,0.257865112071565
"West Virginia",54071,"Pendleton County",2782,820,3659,1962,0.760317026509975,0.22410494670675,0.536212079803225
"West Virginia",54073,"Pleasants County",2742,699,3491,2043,0.785448295617302,0.20022916069894,0.585219134918362
"West Virginia",54075,"Pocahontas County",2895,1047,4008,1848,0.722305389221557,0.26122754491018,0.461077844311377
"West Virginia",54077,"Preston County",11190,3163,14572,8027,0.767911062311282,0.217060115289596,0.550850947021685
"West Virginia",54079,"Putnam County",20034,7878,28501,12156,0.70292270446651,0.276411353987579,0.426511350478931
"West Virginia",54081,"Raleigh County",24673,7982,33106,16691,0.745272760224733,0.24110433154111,0.504168428683622
"West Virginia",54083,"Randolph County",8673,3362,12200,5311,0.710901639344262,0.275573770491803,0.435327868852459
"West Virginia",54085,"Ritchie County",3649,586,4283,3063,0.851972916180248,0.136819985991128,0.71515293018912
"West Virginia",54087,"Roane County",4213,1455,5763,2758,0.731042859621725,0.252472670484123,0.478570189137602
"West Virginia",54089,"Summers County",4074,1448,5585,2626,0.729453894359893,0.259265890778872,0.470188003581021
"West Virginia",54091,"Taylor County",5477,1796,7383,3681,0.741839360693485,0.243261546796695,0.49857781389679
"West Virginia",54093,"Tucker County",2841,938,3844,1903,0.739073881373569,0.244016649323621,0.495057232049948
"West Virginia",54095,"Tyler County",3226,631,3922,2595,0.822539520652728,0.160887302396736,0.661652218255992
"West Virginia",54097,"Upshur County",7771,2256,10221,5515,0.760297426866256,0.22072204285295,0.539575384013306
"West Virginia",54099,"Wayne County",12585,4088,16947,8497,0.742609311382546,0.24122263527468,0.501386676107866
"West Virginia",54101,"Webster County",2759,610,3402,2149,0.810993533215755,0.179306290417402,0.631687242798354
"West Virginia",54103,"Wetzel County",4993,1539,6667,3454,0.748912554372281,0.230838458077096,0.518074096295185
"West Virginia",54105,"Wirt County",2134,466,2653,1668,0.804372408594044,0.175650207312476,0.628722201281568
"West Virginia",54107,"Wood County",27202,10926,38762,16276,0.701769774521439,0.281874000309582,0.419895774211857
"West Virginia",54109,"Wyoming County",7353,1157,8592,6196,0.855796089385475,0.134660148975791,0.721135940409684
"Wisconsin",55001,"Adams County",7362,4329,11818,3033,0.622948045354544,0.366305635471315,0.256642409883229
"Wisconsin",55003,"Ashland County",3841,4801,8757,-960,0.438620532145712,0.54824711659244,-0.109626584446728
"Wisconsin",55005,"Barron County",15803,9194,25346,6609,0.62349088613588,0.362739682790184,0.260751203345696
"Wisconsin",55007,"Bayfield County",4617,6147,10880,-1530,0.424356617647059,0.564981617647059,-0.140625
"Wisconsin",55009,"Brown County",75871,65511,144017,10360,0.526819750446128,0.454883798440462,0.0719359520056659
"Wisconsin",55011,"Buffalo County",4834,2860,7816,1974,0.618474923234391,0.365916069600819,0.252558853633572
"Wisconsin",55013,"Burnett County",6462,3569,10141,2893,0.637215264766788,0.351937678729908,0.28527758603688
"Wisconsin",55015,"Calumet County",18156,12116,30774,6040,0.589978553324235,0.393708975108858,0.196269578215377
"Wisconsin",55017,"Chippewa County",21317,13983,35938,7334,0.593160442985141,0.389086760532027,0.204073682453114
"Wisconsin",55019,"Clark County",10002,4524,14898,5478,0.671365283930729,0.303664921465969,0.36770036246476
"Wisconsin",55021,"Columbia County",16927,16410,33869,517,0.499778558563878,0.484513862233901,0.0152646963299773
"Wisconsin",55023,"Crawford County",4620,3953,8695,667,0.531339850488787,0.454629097182289,0.076710753306498
"Wisconsin",55025,"Dane County",78800,260185,344791,-181385,0.228544248544771,0.754616564817527,-0.526072316272757
"Wisconsin",55027,"Dodge County",31355,16356,48436,14999,0.647349079197291,0.337682715335701,0.30966636386159
"Wisconsin",55029,"Door County",9752,10044,20117,-292,0.484764129840433,0.49927921658299,-0.014515086742556
"Wisconsin",55031,"Douglas County",10923,13218,24677,-2295,0.442638894517162,0.535640474936175,-0.0930015804190137
"Wisconsin",55033,"Dunn County",13173,9897,23524,3276,0.559981295698011,0.420719265431049,0.139262030266961
"Wisconsin",55035,"Eau Claire County",25341,31620,58275,-6279,0.434851994851995,0.542599742599743,-0.107747747747748
"Wisconsin",55037,"Florence County",2133,781,2940,1352,0.725510204081633,0.265646258503401,0.459863945578231
"Wisconsin",55039,"Fond du Lac County",35754,20588,57251,15166,0.624513108941328,0.359609439136434,0.264903669804894
"Wisconsin",55041,"Forest County",3285,1721,5053,1564,0.650108846229962,0.34058974866416,0.309519097565802
"Wisconsin",55043,"Grant County",14142,10998,25608,3144,0.552249297094658,0.429475164011246,0.122774133083411
"Wisconsin",55045,"Green County",10169,10851,21406,-682,0.475053723255162,0.506913949359993,-0.0318602261048305
"Wisconsin",55047,"Green Lake County",7168,3344,10671,3824,0.671727110861213,0.313372692343735,0.358354418517477
"Wisconsin",55049,"Iowa County",5909,7828,13992,-1919,0.422312750142939,0.559462550028588,-0.137149799885649
"Wisconsin",55051,"Iron County",2438,1533,4010,905,0.607980049875312,0.382294264339152,0.22568578553616
"Wisconsin",55053,"Jackson County",5791,4256,10184,1535,0.56863707776905,0.417910447761194,0.150726630007855
"Wisconsin",55055,"Jefferson County",27208,19904,47979,7304,0.567081431459597,0.414848162737864,0.152233268721732
"Wisconsin",55057,"Juneau County",8749,4746,13709,4003,0.638193887227369,0.346195929681231,0.291997957546138
"Wisconsin",55059,"Kenosha County",44972,42193,88738,2779,0.506795284996281,0.475478374540783,0.0313169104554983
"Wisconsin",55061,"Kewaunee County",7927,3976,12095,3951,0.655394791236048,0.328730880529144,0.326663910706904
"Wisconsin",55063,"La Crosse County",28684,37846,67884,-9162,0.422544340345295,0.557509869777856,-0.134965529432561
"Wisconsin",55065,"Lafayette County",4821,3647,8555,1174,0.563530099357101,0.426300409117475,0.137229690239626
"Wisconsin",55067,"Langlade County",7330,3704,11165,3626,0.656515897895208,0.331751007613077,0.324764890282132
"Wisconsin",55069,"Lincoln County",10017,6261,16497,3756,0.607201309328969,0.379523549736316,0.227677759592653
"Wisconsin",55071,"Manitowoc County",27218,16818,44829,10400,0.607151620602735,0.375158937295055,0.23199268330768
"Wisconsin",55073,"Marathon County",44624,30808,76751,13816,0.581412620031009,0.401401936131125,0.180010683899884
"Wisconsin",55075,"Marinette County",15304,7366,22979,7938,0.665999390748074,0.320553548892467,0.345445841855607
"Wisconsin",55077,"Marquette County",5719,3239,9065,2480,0.630888030888031,0.3573083287369,0.273579702151131
"Wisconsin",55078,"Menominee County",278,1303,1590,-1025,0.174842767295597,0.819496855345912,-0.644654088050315
"Wisconsin",55079,"Milwaukee County",134357,317270,458971,-182913,0.292735270855893,0.691263718186988,-0.398528447331095
"Wisconsin",55081,"Monroe County",13775,8433,22611,5342,0.609216752907877,0.372960063685817,0.23625668922206
"Wisconsin",55083,"Oconto County",16226,6715,23215,9511,0.698944647856989,0.289252638380358,0.409692009476632
"Wisconsin",55085,"Oneida County",13671,10105,24159,3566,0.56587607102943,0.418270623784097,0.147605447245333
"Wisconsin",55087,"Outagamie County",58385,47667,108022,10718,0.540491751680213,0.441271222528744,0.0992205291514691
"Wisconsin",55089,"Ozaukee County",33912,26517,61486,7395,0.551540188010279,0.431268906742998,0.12027128126728
"Wisconsin",55091,"Pepin County",2584,1489,4144,1095,0.623552123552124,0.359314671814672,0.264237451737452
"Wisconsin",55093,"Pierce County",12815,9796,23317,3019,0.549599005017798,0.420122657288673,0.129476347729125
"Wisconsin",55095,"Polk County",16611,9370,26371,7241,0.629896477190854,0.355314550073945,0.274581927116909
"Wisconsin",55097,"Portage County",19299,20428,40603,-1129,0.475309706179346,0.503115533334975,-0.0278058271556289
"Wisconsin",55099,"Price County",5394,3032,8546,2362,0.631172478352446,0.354785864732038,0.276386613620407
"Wisconsin",55101,"Racine County",54479,50159,106451,4320,0.511775370827893,0.471193318991837,0.040582051836056
"Wisconsin",55103,"Richland County",4871,3995,9014,876,0.540381628577768,0.443199467495008,0.0971821610827602
"Wisconsin",55105,"Rock County",37138,46658,85360,-9520,0.435074976569822,0.546602624179944,-0.111527647610122
"Wisconsin",55107,"Rusk County",5257,2517,7886,2740,0.666624397666751,0.319173218361654,0.347451179305098
"Wisconsin",55109,"St. Croix County",32199,23190,56707,9009,0.567813497451814,0.408944222053715,0.158869275398099
"Wisconsin",55111,"Sauk County",17493,18108,36203,-615,0.483192000662929,0.500179543131785,-0.0169875424688562
"Wisconsin",55113,"Sawyer County",5909,4498,10510,1411,0.562226450999049,0.427973358705994,0.134253092293054
"Wisconsin",55115,"Shawano County",15173,7131,22615,8042,0.670926376298917,0.315321689144373,0.355604687154543
"Wisconsin",55117,"Sheboygan County",37609,27101,66011,10508,0.569738376937177,0.410552786656769,0.159185590280408
"Wisconsin",55119,"Taylor County",7657,2693,10686,4964,0.71654501216545,0.252011978289351,0.4645330338761
"Wisconsin",55121,"Trempealeau County",8833,6285,15380,2548,0.574317295188557,0.408647594278284,0.165669700910273
"Wisconsin",55123,"Vernon County",8218,7457,15923,761,0.516108773472336,0.468316272059285,0.0477925014130503
"Wisconsin",55125,"Vilas County",9261,5903,15369,3358,0.602576615264493,0.384084846118811,0.218491769145683
"Wisconsin",55127,"Walworth County",33851,22789,57600,11062,0.587690972222222,0.395642361111111,0.192048611111111
"Wisconsin",55129,"Washburn County",6334,3867,10378,2467,0.610329543264598,0.37261514742725,0.237714395837348
"Wisconsin",55131,"Washington County",60237,26650,88070,33587,0.683967298739639,0.302600204382877,0.381367094356762
"Wisconsin",55133,"Waukesha County",159649,103906,267996,55743,0.595714115136047,0.387714742011075,0.207999373124972
"Wisconsin",55135,"Waupaca County",18952,9703,29130,9249,0.650600755235153,0.333093031239272,0.317507723995881
"Wisconsin",55137,"Waushara County",9016,4388,13568,4628,0.664504716981132,0.323408018867925,0.341096698113208
"Wisconsin",55139,"Winnebago County",47796,44060,94032,3736,0.50829504849413,0.46856389314276,0.0397311553513697
"Wisconsin",55141,"Wood County",24308,16365,41298,7943,0.588599932200107,0.396266163010315,0.192333769189791
"Wyoming",56001,"Albany County",8579,9092,18617,-513,0.46081538378901,0.488370843852393,-0.0275554600633829
"Wyoming",56003,"Big Horn County",4806,788,5752,4018,0.835535465924896,0.136995827538248,0.698539638386648
"Wyoming",56005,"Campbell County",16975,1935,19566,15040,0.867576408054789,0.0988960441582337,0.768680363896555
"Wyoming",56007,"Carbon County",5014,1427,6664,3587,0.752400960384154,0.214135654261705,0.538265306122449
"Wyoming",56009,"Converse County",5917,861,6970,5056,0.848923959827834,0.123529411764706,0.725394548063128
"Wyoming",56011,"Crook County",3651,378,4119,3273,0.886380189366351,0.0917698470502549,0.794610342316096
"Wyoming",56013,"Fremont County",12007,5519,18111,6488,0.662967257467837,0.304731930870742,0.358235326597096
"Wyoming",56015,"Goshen County",4878,1203,6241,3675,0.78160551193719,0.192757570902099,0.58884794103509
"Wyoming",56017,"Hot Springs County",1999,482,2577,1517,0.775708187815289,0.187039192859915,0.588668994955374
"Wyoming",56019,"Johnson County",3881,897,4914,2984,0.78978428978429,0.182539682539683,0.607244607244607
"Wyoming",56021,"Laramie County",27891,15217,44982,12674,0.620048019207683,0.338290871904317,0.281757147303366
"Wyoming",56023,"Lincoln County",8643,1509,10468,7134,0.82565915170042,0.144153611004968,0.681505540695453
"Wyoming",56025,"Natrona County",25271,8530,35202,16741,0.717885347423442,0.242315777512641,0.475569569910801
"Wyoming",56027,"Niobrara County",1118,155,1308,963,0.85474006116208,0.118501529051988,0.736238532110092
"Wyoming",56029,"Park County",12813,3410,16717,9403,0.766465274869893,0.203983968415386,0.562481306454507
"Wyoming",56031,"Platte County",3898,890,4923,3008,0.79179362177534,0.180784074751168,0.611009547024172
"Wyoming",56033,"Sheridan County",11843,4043,16428,7800,0.720903335768201,0.246104212320429,0.474799123447772
"Wyoming",56035,"Sublette County",3957,882,4970,3075,0.796177062374245,0.177464788732394,0.618712273641851
"Wyoming",56037,"Sweetwater County",12229,3823,16603,8406,0.736553634885262,0.230259591640065,0.506294043245197
"Wyoming",56039,"Teton County",4341,9848,14677,-5507,0.295768890100157,0.670981808271445,-0.375212918171288
"Wyoming",56041,"Uinta County",7496,1591,9402,5905,0.797277175069134,0.169219315039353,0.628057860029781
"Wyoming",56043,"Washakie County",3245,651,4012,2594,0.808823529411765,0.162263210368893,0.646560319042871
"Wyoming",56045,"Weston County",3107,360,3542,2747,0.877188029361942,0.101637492941841,0.775550536420102
